0_0.map
[RSC]
H mountain.png
G ground.png
D dirt.png
M mountain.png

[AT]
MMMMMMMMMMMMMMMMMMMMMMMMMMMM
MMMMMMMMMMMMMMMMMMMMMMMMMMMM
MMMMMMMMMMMMMMMMMMMMMMMMMMMM
MMM.........................
MMM.........HHHHH...........
MMM.........HHHHH...........
MMM.........HHHHH...........
MMM.........HHHHH...........
MMM.........................
MMM.........................
MMM.........................
MMM.........................
MMM.........................
MMM.........................
MMM.........................
MMM.........................
MMM............HHHHH........
MMM............HHHHH........
MMM............HHHHH........
MMM............HHHHH........
MMM.........................
MMM.........................
MMM.........................
MMM.........................

[UNDER]
............................
............................
............................
...GGGGGGGGGGGGGGGGGGGGGGGGG
...GGGGGGGGG.....GGGGGGGGGGG
...GGGGGGGGG.....GGGGGGGGGGG
...GGGGGGGGG.....GGGGGGGGGGG
...GGGGGGGGG.....GGGGGGGGGGG
...GGGGGGGGGGDDDGGGGGGGGGGGG
...GGGGGGGGGGDDDGGGGGGGGGGGG
...GGGGGGGGGGDDDDDDDDDDDDDDD
...GGGGGGGGGGDDDDDDDDDDDDDDD
...GGGGGGGGGGDDDDDDDDDDDDDDD
...GGGGGGGGGGGGGDDDGGGGGGGGG
...GGGGGGGGGGGGGDDDGGGGGGGGG
...GGGGGGGGGGGGGDDDGGGGGGGGG
...GGGGGGGGGGGG.....GGGGGGGG
...GGGGGGGGGGGG.....GGGGGGGG
...GGGGGGGGGGGG.....GGGGGGGG
...GGGGGGGGGGGG.....GGGGGGGG
...GGGGGGGGGGGGGGGGGGGGGGGGG
...GGGGGGGGGGGGGGGGGGGGGGGGG
...GGGGGGGGGGGGGGGGGGGGGGGGG
...GGGGGGGGGGGGGGGGGGGGGGGGG

[ENTITY]
