0_4.map
[RSC]
G grass.png
M mountain.png
D dirt.png
[AT]
MMM.........................
MMM.........................
MMM.........................
MMM.........................
MMM.........................
MMM.........................
MMM.........................
MMM.........................
MMM.........................
MMM.........................
MMM.........................
MMMMMMMMMMMMMMMMMMMMMMMMMMMM
MMMMMMMMMMMMMMMMMMMMMMMMMMMM
MMMMMMMMMMMMMMMMMMMMMMMMMMMM
MMM.........................
MMM.........................
MMM.........................
MMM.........................
MMM.........................
MMM.........................
MMM.........................
MMM.........................
MMM.........................
MMM.........................
[UNDER]
...GGGGGGGGGGGGGGGGGGGGGGGGG
...GGGGGGGGGGGGGGGGGGGGGGGGG
...GGGGGGGGGGGGGGGGGGGGGGGGG
...GGGGGGGGGGGGGGGGGGGGGGGGG
...GGGGGGGGGGGGGGGGGGGGGGGGG
...GGGGGGGGGGGGGGGGGGGGGGGGG
...GGGGGGGGGGGGGGGGGGGGGGGGG
...GGGGGGGGGGGGGGGGGGGGGGGGG
...GGGGGGGGGGGGGGGGGGGGGGGGG
...GGGGGGGGGGGGGGGGGGGGGGGGG
...GGGGGGGGGGGGGGGGGGGGGGGGG
...MMMMMMMMMMMMMMMMMMMMMMMMM
...MMMMMMMMMMMMMMMMMMMMMMMMM
...MMMMMMMMMMMMMMMMMMMMMMMMM
...DDDDDDDDDDDDDDDDDDDDDDDDD
...DDDDDDDDDDDDDDDDDDDDDDDDD
...DDDDDDDDDDDDDDDDDDDDDDDDD
...DDDDDDDDDDDDDDDDDDDDDDDDD
...DDDDDDDDDDDDDDDDDDDDDDDDD
...DDDDDDDDDDDDDDDDDDDDDDDDD
...DDDDDDDDDDDDDDDDDDDDDDDDD
...DDDDDDDDDDDDDDDDDDDDDDDDD
...DDDDDDDDDDDDDDDDDDDDDDDDD
...DDDDDDDDDDDDDDDDDDDDDDDDD
[ENTITY]
