-
[RSC]
S sand.png
M mountain.png

[AT]
MMM.........................
M...........................
M...........................
M...........................
M...........................
M...........................
M...........................
M...........................
M...........................
M...........................
M...........................
M...........................
M...........................
M...........................
M...........................
M...........................
M...........................
M...........................
M...........................
M...........................
M...........................
M...........................
M...........................
M...........................

[UNDER]
...SSSSSSSSSSSSSSSSSSSSSSSSS
.SSSSSSSSSSSSSSSSSSSSSSSSSSS
.SSSSSSSSSSSSSSSSSSSSSSSSSSS
.SSSSSSSSSSSSSSSSSSSSSSSSSSS
.SSSSSSSSSSSSSSSSSSSSSSSSSSS
.SSSSSSSSSSSSSSSSSSSSSSSSSSS
.SSSSSSSSSSSSSSSSSSSSSSSSSSS
.SSSSSSSSSSSSSSSSSSSSSSSSSSS
.SSSSSSSSSSSSSSSSSSSSSSSSSSS
.SSSSSSSSSSSSSSSSSSSSSSSSSSS
.SSSSSSSSSSSSSSSSSSSSSSSSSSS
.SSSSSSSSSSSSSSSSSSSSSSSSSSS
.SSSSSSSSSSSSSSSSSSSSSSSSSSS
.SSSSSSSSSSSSSSSSSSSSSSSSSSS
.SSSSSSSSSSSSSSSSSSSSSSSSSSS
.SSSSSSSSSSSSSSSSSSSSSSSSSSS
.SSSSSSSSSSSSSSSSSSSSSSSSSSS
.SSSSSSSSSSSSSSSSSSSSSSSSSSS
.SSSSSSSSSSSSSSSSSSSSSSSSSSS
.SSSSSSSSSSSSSSSSSSSSSSSSSSS
.SSSSSSSSSSSSSSSSSSSSSSSSSSS
.SSSSSSSSSSSSSSSSSSSSSSSSSSS
.SSSSSSSSSSSSSSSSSSSSSSSSSSS
.SSSSSSSSSSSSSSSSSSSSSSSSSSS

[ENTITY]
