1_0.map
[RSC]
G ground.png
D dirt.png
M mountain.png
s fronthouseshingles.png
W fronthousewall.png
w fronthousewindow.png

[AT]
MMMMMMMMMMMMMMMMMMMMMMMMMMMM
MMMMMMMMMMMMMMMMMMMMMMMMMMMM
MMMMMMMMMMMMMMMMMMMMMMMMMMMM
............................
............................
............................
............................
............................
............................
............................
............................
............................
.................ssssss.....
.................WwWWwW.....
.................WWWWWW.....
.................WWWWWW.....
............................
............................
............................
............................
............................
............................
............................
............................

[UNDER]
............................
............................
............................
GGGGGGGGGGGGGGGGGGGGGGGGGGGG
GGGGGGGGGGGGGGGGGGGGGGGGGGGG
GGGGGGGGGGGGGGGGGGGGGGGGGGGG
GGGGGGGGGGGGGGGGGGGGGGGGGGGG
GGGGGGGGGGGGGGGGGGGGGGGGGGGG
GGGGGGGGGGGGGGGGGGGGGGGGGGGG
GGGGGGGGGGGGGGGGGGGGGGGGGGGG
DDDDDDDDDDDDDDDGG......GGGGG
DDDDDDDDDDDDDDDGG......GGGGG
DDDDDDDDDDDDDDDGG......GGGGG
GGGGGGGGGGGGDDDGG......GGGGG
GGGGGGGGGGGGDDDDD......GGGGG
GGGGGGGGGGGGDDDDD......GGGGG
GGGGGGGGGGGGDDDGGGGGGGGGGGGG
GGGGGGGGGGGGDDDGGGGGGGGGGGGG
GGGGGGGGGGGGDDDGGGGGGGGGGGGG
GGGGGGGGGGGGDDDGGGGGGGGGGGGG
GGGGGGGGGGGGDDDGGGGGGGGGGGGG
GGGGGGGGGGGGDDDGGGGGGGGGGGGG
GGGGGGGGGGGGDDDGGGGGGGGGGGGG
GGGGGGGGGGGGDDDGGGGGGGGGGGGG
[OVER]
............................
............................
............................
............................
............................
............................
............................
............................
............................
............................
.................ssssss.....
.................ssssss.....
............................
............................
............................
............................
............................
............................
............................
............................
............................
............................
............................
............................
[ENTITY]
