2_3.map
[RSC]
G ground.png
D dirt.png
M mountain.png
h fronthousewall.png
s fronthouseshingles.png
c fronthousewindow.png

[AT]
............................
............................
............................
............................
............................
............................
............................
............................
............................
............................
............................
............................
............................
............................
............................
............................
............................
............................
..............sssssss.......
..............hcchcch.......
..............hhhhhhh.......
............................
............................
............................

[UNDER]
GGGGGGGGGGGGGGGGGGGGGGGGGGGG
GGGGGGGGGGGGGGGGGGGGGGGGGGGG
GGGGGGGGGGGGGGGGGGGGGGGGGGGG
GGGGGGGGGGGGGGGGGGGGGGGGGGGG
GGGGGGGGGGGGGGGGGGGGGGGGGGGG
GGGGGGGGGGGGGGGGGGGGGGGGGGGG
GGGGGGGGGGGGGGGGGGGGGGGGGGGG
GGGGGGGGGGGGGGGGGGGGGGGGGGGG
GGGGGGGGGGGGGGGGGGGGGGGGGGGG
GGGGGGGGGGGGGGGGGGGGGGGGGGGG
DDDDDDDDDDDDDDDDDDDDDDDDDDDD
DDDDDDDDDDDDDDDDDDDDDDDDDDDD
DDDDDDDDDDDDDDDDDDDDDDDDDDDD
DDDDDDDDDDDDDDDDDDDDDDDDDDDD
GGGGGGGGGGGGGGGGDDDGGGGGGGGG
GGGGGGGGGGGGGGGGDDDGGGGGGGGG
GGGGGGGGGGGGGGG.....GGGGGGGG
GGGGGGGGGGGGGGG.....GGGGGGGG
GGGGGGGGGGGGGGG.....GGGGGGGG
GGGGGGGGGGGGGGG.....GGGGGGGG
GGGGGGGGGGGGGGGGGGGGGGGGGGGG
GGGGGGGGGGGGGGGGGGGGGGGGGGGG
GGGGGGGGGGGGGGGGGGGGGGGGGGGG
GGGGGGGGGGGGGGGGGGGGGGGGGGGG
[OVER]
............................
............................
............................
............................
............................
............................
............................
............................
............................
............................
............................
............................
............................
............................
............................
............................
..............sssssss.......
..............sssssss.......
............................
............................
............................
............................
............................
............................

[ENTITY]
