2_8.map
[RSC]
S sand.png
W water.png
G grass.png
T palmTreeBottom.png
Q palmTreeTop.png

[AT]
............................
............................
............................
............................
............................
.........T....T.............
..............WWWW..........
.........WWWWWW..W..........
........W.........WT........
......TW..........W.........
.......W...........W........
.......WW.........W.........
.........WW.......W.........
.........T.WW....W..........
.............WWWW..T........
...............T............
............................
............................
............................
............................
............................
............................
............................
............................

[UNDER]
SSSSSSSSSSSSSSSSSSSSSSSSSSSS
SSSSSSSSSSSSSSSSSSSSSSSSSSSS
SSSSSSSSSSSSSSSSSSSSSSSSSSSS
SSSSSSSSSSSSSSSSSSSSSSSSSSSS
SSSSSSSSSSSSGGGGGGSSSSSSSSSS
SSSSSSSSGGGGGGGGGGGGSSSSSSSS
SSSSSSGGGGGGGGWWWWGGSSSSSSSS
SSSSSSGGGWWWWWWWWWGGGSSSSSSS
SSSSSGGGWWWWWWWWWWWGGGSSSSSS
SSSSSGGWWWWWWWWWWWWGGGSSSSSS
SSSSSGGWWWWWWWWWWWWWGGSSSSSS
SSSSSGGWWWWWWWWWWWWGGGSSSSSS
SSSSSGGGGWWWWWWWWWWGGGSSSSSS
SSSSSSGGGGGWWWWWWWGGGSSSSSSS
SSSSSSSSGGGGGWWWWGGGSSSSSSSS
SSSSSSSSSSGGGGGGGGGSSSSSSSSS
SSSSSSSSSSSSSGGGGGSSSSSSSSSS
SSSSSSSSSSSSSSSSSSSSSSSSSSSS
SSSSSSSSSSSSSSSSSSSSSSSSSSSS
SSSSSSSSSSSSSSSSSSSSSSSSSSSS
SSSSSSSSSSSSSSSSSSSSSSSSSSSS
SSSSSSSSSSSSSSSSSSSSSSSSSSSS
SSSSSSSSSSSSSSSSSSSSSSSSSSSS
SSSSSSSSSSSSSSSSSSSSSSSSSSSS
[OVER]
............................
............................
............................
............................
.........Q....Q.............
............................
............................
...................Q........
......Q.....................
............................
............................
............................
.........Q..................
...................Q........
...............Q............
............................
............................
............................
............................
............................
............................
............................
............................
............................

[ENTITY]
