2_8.map
[RSC]
S sand.png
W water.png
G grass.png

[AT]
............................
............................
............................
............................
............................
............................
..............WWWW..........
.........WWWWWW..W..........
........W.........W.........
.......W..........W.........
.......W...........W........
.......WW.........W.........
.........WW.......W.........
...........WW....W..........
.............WWWW...........
............................
............................
............................
............................
............................
............................
............................
............................
............................

[UNDER]
SSSSSSSSSSSSSSSSSSSSSSSSSSSS
SSSSSSSSSSSSSSSSSSSSSSSSSSSS
SSSSSSSSSSSSSSSSSSSSSSSSSSSS
SSSSSSSSSSSSSSSSSSSSSSSSSSSS
SSSSSSSSSSSSGGGGGGSSSSSSSSSS
SSSSSSSSGGGGGGGGGGGGSSSSSSSS
SSSSSSGGGGGGGGWWWWGGSSSSSSSS
SSSSSSGGGWWWWWWWWWGGGSSSSSSS
SSSSSGGGWWWWWWWWWWWGGGSSSSSS
SSSSSGGWWWWWWWWWWWWGGGSSSSSS
SSSSSGGWWWWWWWWWWWWWGGSSSSSS
SSSSSGGWWWWWWWWWWWWGGGSSSSSS
SSSSSGGGGWWWWWWWWWWGGGSSSSSS
SSSSSSGGGGGWWWWWWWGGGSSSSSSS
SSSSSSSSGGGGGWWWWGGGSSSSSSSS
SSSSSSSSSSGGGGGGGGGSSSSSSSSS
SSSSSSSSSSSSSGGGGGSSSSSSSSSS
SSSSSSSSSSSSSSSSSSSSSSSSSSSS
SSSSSSSSSSSSSSSSSSSSSSSSSSSS
SSSSSSSSSSSSSSSSSSSSSSSSSSSS
SSSSSSSSSSSSSSSSSSSSSSSSSSSS
SSSSSSSSSSSSSSSSSSSSSSSSSSSS
SSSSSSSSSSSSSSSSSSSSSSSSSSSS
SSSSSSSSSSSSSSSSSSSSSSSSSSSS

[ENTITY]
