3_0.map
[RSC]
G grass.png
M mountain.png
D dirt.png
[AT]
MMMMMMMMMMMMMMMMMMMMMMMMMMMM
MMMMMMMMMMMMMMMMMMMMMMMMMMMM
MMMMMMMMMMMMMMMMMMMMMMMMMMMM
............MMM.............
............MMM.............
............MMM.............
............MMM.............
............MMM.............
............MMM.............
............MMM.............
............MMM.............
............MMM.............
............MMM.............
............MMM.............
............MMM.............
............MMM.............
............MMM.............
............MMM.............
............MMM.............
............MMM.............
............MMM.............
............MMM.............
............MMM.............
............MMM.............
[UNDER]
GGGGGGGGGGGGMMMDDDDDDDDDDDDD
GGGGGGGGGGGGMMMDDDDDDDDDDDDD
GGGGGGGGGGGGMMMDDDDDDDDDDDDD
GGGGGGGGGGGGMMMDDDDDDDDDDDDD
GGGGGGGGGGGGMMMDDDDDDDDDDDDD
GGGGGGGGGGGGMMMDDDDDDDDDDDDD
GGGGGGGGGGGGMMMDDDDDDDDDDDDD
GGGGGGGGGGGGMMMDDDDDDDDDDDDD
GGGGGGGGGGGGMMMDDDDDDDDDDDDD
GGGGGGGGGGGGMMMDDDDDDDDDDDDD
GGGGGGGGGGGGMMMDDDDDDDDDDDDD
GGGGGGGGGGGGMMMDDDDDDDDDDDDD
GGGGGGGGGGGGMMMDDDDDDDDDDDDD
GGGGGGGGGGGGMMMDDDDDDDDDDDDD
GGGGGGGGGGGGMMMDDDDDDDDDDDDD
GGGGGGGGGGGGMMMDDDDDDDDDDDDD
GGGGGGGGGGGGMMMDDDDDDDDDDDDD
GGGGGGGGGGGGMMMDDDDDDDDDDDDD
GGGGGGGGGGGGMMMDDDDDDDDDDDDD
GGGGGGGGGGGGMMMDDDDDDDDDDDDD
GGGGGGGGGGGGMMMDDDDDDDDDDDDD
GGGGGGGGGGGGMMMDDDDDDDDDDDDD
GGGGGGGGGGGGMMMDDDDDDDDDDDDD
GGGGGGGGGGGGMMMDDDDDDDDDDDDD
[ENTITY]
