The (4,0) position in the world map
[RSC]
M mountain.png
G grass.png
O water.png
S sand.png
s sand.png 'Change back to halfsand.png when such file exists
[AT]
............................
............................
MMMMMMM.....................
.......O....................
.......O....................
.......O....................
.......O....................
.......O....................
.......O....................
.......O....................
.......O....................
.......O....................
.......O....................
.......O....................
.......O....................
.......O....................
.......O....................
.......O....................
.......O....................
.......O....................
.......O....................
.......O....................
.......O....................
.......O....................
[UNDER]
MMMMMMMMOOOOOOOOOOOOOOOOOOOO
MMMMMMMMOOOOOOOOOOOOOOOOOOOO
GGGGGSSSOOOOOOOOOOOOOOOOOOOO
GGGGGSSSOOOOOOOOOOOOOOOOOOOO
GGGGGSSSOOOOOOOOOOOOOOOOOOOO
GGGGGSSSOOOOOOOOOOOOOOOOOOOO
GGGGGSSSOOOOOOOOOOOOOOOOOOOO
GGGGGSSSOOOOOOOOOOOOOOOOOOOO
GGGGGSSSOOOOOOOOOOOOOOOOOOOO
GGGGGSSSOOOOOOOOOOOOOOOOOOOO
GGGGGSSSOOOOOOOOOOOOOOOOOOOO
GGGGGSSSOOOOOOOOOOOOOOOOOOOO
GGGGGSSSOOOOOOOOOOOOOOOOOOOO
GGGGGSSSOOOOOOOOOOOOOOOOOOOO
GGGGGSSSOOOOOOOOOOOOOOOOOOOO
GGGGGSSSOOOOOOOOOOOOOOOOOOOO
GGGGGSSSOOOOOOOOOOOOOOOOOOOO
GGGGGSSSOOOOOOOOOOOOOOOOOOOO
GGGGGSSSOOOOOOOOOOOOOOOOOOOO
GGGGGSSSOOOOOOOOOOOOOOOOOOOO
GGGGGSSSOOOOOOOOOOOOOOOOOOOO
GGGGGSSSOOOOOOOOOOOOOOOOOOOO
GGGGGSSSOOOOOOOOOOOOOOOOOOOO
GGGGGSSSOOOOOOOOOOOOOOOOOOOO
[ENTITY]
