The (4,1) position in the map grid
[RSC]
O water.png
S sand.png
B waterWithStone.png
G grass.png
[AT]
.......O....................
.......O....................
.......O....................
.......O....................
.......O....................
.......O....................
.......O....................
.......O....................
.......O....................
.......O....................
.......O....................
.......O....................
.......O....................
.......O....................
.......OOO..............OOOO
..........O..........OOO....
..........O.......OOO.......
...........OOOOOOO........OO
.......................OOO..
....................OOO.....
............OOOOOOOO........
.............OOOO...........
.................OOO........
....................O.......
[UNDER]
GGGGGSSSOOOOOOOOOOOOOOOOOOOO
GGGGGSSSOOOOOOOOOOOOOOOOOOOO
GGGGGSSSOOOOOOOOOOOOOOOOOOOO
GGGGGSSSOOOOOOOOOOOOOOOOOOOO
GGGGGSSSOOOOOOOOOOOOOOOOOOOO
GGGGGSSSOOOOOOOOOOOOOOOOOOOO
GGGGGSSSOOOOOOOOOOOOOOOOOOOO
GGGGGSSSOOOOOOOOOOOOOOOOOOOO
GGGGGSSSOOOOOOOOOOOOOOOOOOOO
GGGGGSSSOOOOOOOOOOOOOOOOOOOO
GGGGGSSSOOOOOOOOOOOOOOOOOOOO
GGGGGSSSOOOOOOOOOOOOOOOOOOOO
GGGGGSSSOOOOOOOOOOOOOOOOOOOO
GGGGGSSSOOOOOOOOOOOOOOOOOOOO
GGGGGSSSOOOOOOOOOOOOOOOOOOOO
GGGGGGGSSSOOOOOOOOOOOOOOBBBB
GGGGGGGSSSOOOOOOOOOOOBBBBBBB
GGGGGGGGSSSOOOOOOOBBBBBBBBOO
GGGGGGGGSSSBBBBBBBBBBBBOOOOO
GGGGGGGGGSSSBBBBBBBBOOOOOOOO
GGGGGGGGGSSSOOOOOOOOOOOOOOOO
GGGGGGGGGGSSSOOOOOOOOOOOOOOO
GGGGGGGGGGSSSSSSSOOOOOOOOOOO
GGGGGGGGGGGGSSSSSSSSOOOOOOOO
[ENTITY]
