Tile4_2
[RSC]
G grass.png
M rockyMountain.png
s sand.png
O water.png
[AT]
....................O.......
.....................O......
......................O.....
......................O.....
.......................OO...
.........................OO.
...........................O
............................
............................
............................
............................
............................
............................
............................
............................
............................
............................
............................
............................
............................
............................
............................
............................
............................
[UNDER]
GGGGGGGGGGGGssssssss.OOOOOOO
GGGGGGGGGGGGGssssssss.OOOOOO
GGGGGGGGGGGGGGGsssssss.OOOOO
GGGGGGGGGGGGGGGGGsssss.OOOOO
GGGGGGGGGGGGGGGGGGGssss..OOO
GGGGGGGGGGGGGGGGGGGGGssss..O
GGGGGGGGGGGGGGGGGGGGGGGGsss.
GGGGGGGGGGGGGGGGGGGGGGGGGsss
GGGGGGGGGGGGGGGGGGGGGGGGGGGs
GGGGGGGGGGGGGGGGGGGGGGGGGGGG
GGGGGGGGGGGGGGGGGGGGGGGGGGGG
GGGGGGGGGGGGGGGGGGGGGGGGGGGG
GGGGGGGGGGGGGGGGGGGGGGGGGGGG
GGGGGGGGGGGGGGGGGGGGGGGGGGGG
GGGGGGGGGGGGGGGGGGGGGGGGGGGG
GGGGGGGGGGGGGGGGGGGGGGGGGGGG
GGGGGGGGGGGGGGGGGGGGGGGGGGGG
GGGGGGGGGGGGGGGGGGGGGGGGGGGG
GGGGGGGGGGGGGGGGGGGGGGGGGGGG
GGGGGGGGGGGGGGGGGGGGGGGGGGGG
GGGGGGGGGGGGGGGGGGGGGGGGGGGG
GGGGGGGGGGGGGGGGGGGGGGGGGGGG
GGGGGGGGGGGGGGGGGGGGGGGGGGGG
GGGGGGGGGGGGGGGGGGGGGGGGGGGG
[ENTITY]