4-9
[RSC]
M rockyMountain.png
G grass.png

[AT]
.MMMMMMMMMMMMMMMMMMMMMMMMMMM
.MMMMMMMMMMMMMMMMMMMMMMMMMMM
.MMMMMMMMMMMMMMMMMMMMMMMMMMM
.MMMMMMMMMMMMMMMMMMMMMMMMMMM
.MMMMMMMMMMMMMMMMMMMMMMMMMMM
.MMMMMMMMMMMMMMMMMMMMMMMMMMM
.MMMMMMMMMMMMMMMMMMMMMMMMMMM
.MMMMMMMMMMMMMMMMMMMMMMMMMMM
.MMMMMMMMMMMMMMMMMMMMMMMMMMM
.MMMMMMMMMMMMMMMMMMMMMMMMMMM
.MMMMMMMMMMMMMMMMMMMMMMMMMMM
.MMMMMMMMMMMMMMMMMMMMMMMMMMM
.MMMMMMMMMMMMMMMMMMMMMMMMMMM
.MMMMMMMMMMMMMMMMMMMMMMMMMMM
.MMMMMMMMMMMMMMMMMMMMMMMMMMM
.MMMMMMMMMMMMMMMMMMMMMMMMMMM
.MMMMMMMMMMMMMMMMMMMMMMMMMMM
.MMMMMMMMMMMMMMMMMMMMMMMMMMM
.MMMMMMMMMMMMMMMMMMMMMMMMMMM
.MMMMMMMMMMMMMMMMMMMMMMMMMMM
.MMMMMMMMMMMMMMMMMMMMMMMMMMM
.MMMMMMMMMMMMMMMMMMMMMMMMMMM
.MMMMMMMMMMMMMMMMMMMMMMMMMMM
MMMMMMMMMMMMMMMMMMMMMMMMMMMM

[UNDER]
GGGGGGGGGGGGGGGGGGGGGGGGGGGG
GGGGGGGGGGGGGGGGGGGGGGGGGGGG
GGGGGGGGGGGGGGGGGGGGGGGGGGGG
GGGGGGGGGGGGGGGGGGGGGGGGGGGG
GGGGGGGGGGGGGGGGGGGGGGGGGGGG
GGGGGGGGGGGGGGGGGGGGGGGGGGGG
GGGGGGGGGGGGGGGGGGGGGGGGGGGG
GGGGGGGGGGGGGGGGGGGGGGGGGGGG
GGGGGGGGGGGGGGGGGGGGGGGGGGGG
GGGGGGGGGGGGGGGGGGGGGGGGGGGG
GGGGGGGGGGGGGGGGGGGGGGGGGGGG
GGGGGGGGGGGGGGGGGGGGGGGGGGGG
GGGGGGGGGGGGGGGGGGGGGGGGGGGG
GGGGGGGGGGGGGGGGGGGGGGGGGGGG
GGGGGGGGGGGGGGGGGGGGGGGGGGGG
GGGGGGGGGGGGGGGGGGGGGGGGGGGG
GGGGGGGGGGGGGGGGGGGGGGGGGGGG
GGGGGGGGGGGGGGGGGGGGGGGGGGGG
GGGGGGGGGGGGGGGGGGGGGGGGGGGG
GGGGGGGGGGGGGGGGGGGGGGGGGGGG
GGGGGGGGGGGGGGGGGGGGGGGGGGGG
GGGGGGGGGGGGGGGGGGGGGGGGGGGG
GGGGGGGGGGGGGGGGGGGGGGGGGGGG
GGGGGGGGGGGGGGGGGGGGGGGGGGGG

[ENTITY]
