The (5,0) position in the map grid
[RSC]
S sand.png
W water.png
[AT]
............................
............................
............................
............................
............................
............................
............................
............................
............................
............................
............................
............................
............................
.........................WWW
........................W...
........................W...
........................W...
.......................WW...
......................W.....
.....................W......
.....................W......
......................W.....
.......................W....
......................W.....
[UNDER]
WWWWWWWWWWWWWWWWWWWWWWWWWWWW
WWWWWWWWWWWWWWWWWWWWWWWWWWWW
WWWWWWWWWWWWWWWWWWWWWWWWWWWW
WWWWWWWWWWWWWWWWWWWWWWWWWWWW
WWWWWWWWWWWWWWWWWWWWWWWWWWWW
WWWWWWWWWWWWWWWWWWWWWWWWWWWW
WWWWWWWWWWWWWWWWWWWWWWWWWWWW
WWWWWWWWWWWWWWWWWWWWWWWWWWWW
WWWWWWWWWWWWWWWWWWWWWWWWWWWW
WWWWWWWWWWWWWWWWWWWWWWWWWWWW
WWWWWWWWWWWWWWWWWWWWWWWWWWWW
WWWWWWWWWWWWWWWWWWWWWWWWWWWW
WWWWWWWWWWWWWWWWWWWWWWWWWWWW
WWWWWWWWWWWWWWWWWWWWWWWWWWWW
WWWWWWWWWWWWWWWWWWWWWWWWWSSS
WWWWWWWWWWWWWWWWWWWWWWWWWSSS
WWWWWWWWWWWWWWWWWWWWWWWWWSSS
WWWWWWWWWWWWWWWWWWWWWWWWWSSS
WWWWWWWWWWWWWWWWWWWWWWWSSSSS
WWWWWWWWWWWWWWWWWWWWWWSSSSSS
WWWWWWWWWWWWWWWWWWWWWWSSSSSS
WWWWWWWWWWWWWWWWWWWWWWWSSSSS
WWWWWWWWWWWWWWWWWWWWWWWWSSSS
WWWWWWWWWWWWWWWWWWWWWWWSSSSS
[ENTITY]
