Tile5_3
[RSC]
G grass.png
r rubble.png
[AT]
.....................r......
.rrrrrrrrrrrrr..............
.r..........rr.......rr..r..
.r....r...r.rr...r...r......
.r....................r.....
.....................r......
.........r...r.r.....rr.rr.r
.rr..........r........r.....
.r....r......r.........r....
.r.r...rr....r.......r......
.rrrr..rrrrrrr.......rrr.rrr
................r.....r....r
........rrr..........rr....r
....................r......r
......................r....r
....................r.r.r..r
......................r..rrr
..........................r.
.......................r....
....................r.r..r..
......................r.....
...................r..r.....
..................r....r..r.
............................
[UNDER]
.............GGGGGGGG.GGGGGG
.GGG.GGGGGGG.GGGGGGGGGGGGGGG
.GGGGGGGGGGG.GGGGGGGG..GG.GG
.GGGGG.GGG.G.GGGG.GGG.GGGGGG
.GGGGGGGGGGGGGGGGGGGGG.GGGGG
..GGGGGGGGGG.GGGGGGGG.GGGGGG
GGGGGGGGG.GG.GG.GGGGG..G..G.
.G.GGGGGGGGG.GGGGGGGGG.GGGGG
.GGGGG.GGGGG.GGGGGGGGGG.GGGG
....G....G...GGGGGGGG.GGGGGG
GGGGGGGGGGGGGGGGGGGGG...G...
GGGGGGGGG.GGGGGG.GGGGG.GGGG.
GGGGGGGG...GGGGGGGGGG..GGGG.
GGGGGGGGGGGGGGGGGGGG.GGGGGG.
GGGGGGGGGGGGGGGGGGGGGG.GGGG.
GGGGGGGGGGGGGGGGGGGG.G.G.GG.
GGGGGGGGGGGGGGGGGGGGGG.GG...
GGGGGGGGGGGGGGGGGGGGGGGGGGGG
GGGGGGGGGGGGGGGGGGGGGGG.GGGG
GGGGGGGGGGGGGGGGGGGGGGGGGGGG
GGGGGGGGGGGGGGGGGGGGGGGGGGGG
GGGGGGGGGGGGGGGGGGGGGGGGGGGG
GGGGGGGGGGGGGGGGGGGGGGGGGGGG
GGGGGGGGGGGGGGGGGGGGGGGGGGGG
[ENTITY]



