5_5.map
[RSC]
G grassDead.png
M rockyMountain.png
# waterToxic.png
S waterToxicWithStone.png
[AT]
MMMMMMMMMMMMMMMMMMMMMMMMMMMM
MMMMMMMMMMMMMMMMMMMMMMMMMMMM
MM##########################
MM##....##....##############
MM##.##.##.##.##############
MM##.##....##.##############
MM##.########.##############
MM##..#######.##############
MM##......###.##############
MM##.####...#.##############
MM##.######.#.....##########
MM##.######.#####.##########
MM##.........####.##########
MM##.#######.####.##########
MM##.#######.#....##########
MM##.#######.#.#############
MM##.#######.#.#############
MM##.#######...#############
MM##.#########.#############
MM##...#######.#############
MM####.#######.######.......
MM####.#######.######.......
MM####.#######.....##.......
MM####.###########.##.....MM
[UNDER]
MMMMMMMMMMMMMMMMMMMMMMMMMMMM
MMMMMMMMMMMMMMMMMMMMMMMMMMMM
MM##########################
MM##SSSS##SSSS##############
MM##S##S##S##S##############
MM##S##SSSS##S##############
MM##S########S##############
MM##SS#######S##############
MM##SSSSSS###S##############
MM##S####SSS#S##############
MM##S######S#SSSSS##########
MM##S######S#####S##########
MM##SSSSSSSSS####S##########
MM##S#######S####S##########
MM##S#######S#SSSS##########
MM##S#######S#S#############
MM##S#######S#S#############
MM##S#######SSS#############
MM##S#########S#############
MM##SSS#######S#############
MM####S#######S######GGGGGGG
MM####S#######S######GGGGGGG
MM####S#######SSSSS##GGGGGGG
MM####S###########S##GGGGGGG
[ENTITY]




















