5_7.map
[RSC]
G grassDead.png
M rockyMountain.png
# waterToxic.png
W wall.png
R rubbleDead.png
S waterToxicWithStone.png
Q treeDyingTop.png
T treeDyingBottom.png
F treeDyingForest.png
[AT]
MMMMMMMMMMMMMMM...WWWWWWWWWW
MM.T.T..............W......W
MM......FF...F......W......F
MM......FF.F.F......W......F
MMTTTT..TT.F.T......W......F
MM.........F........WWWWW..F
MM.........FWW.............T
MM...F.....F................
MM...F.....F....TTTTTTTTTF..
MM...T.....T.............T..
MM...WWWWWWWWWWWWWWW......TT
MM..................F.......
MM..................F.......
MM###############...TTTTTTTT
MM###############...######.W
MM###############...######.W
MM###############...######.W
MM################.#######.W
MM################.#######.W
MM..................######.W
MM.........T........######.W
MM.T...........T...........W
MM.........................W
MMWWWWWWWWWWWWWWWWWWWWWWWWWW
[UNDER]
MMMMMMMMMMMMMMMGGGGGGGGGGGGW
MMGGGGGGGGGGGGGGRGGGGGGGGGGG
MMGGGGGGGGGGGGGGGGGGGGGGGGGG
MMGGGGGGGGGGGGGGGGGGGGGGGGGG
MMGGGGGGGGGGGGGGGGGGGGGGGGGG
MMGGGGGGGGGGGGGGGGGGGGGGGGGG
MMGGGGGGGGGGGGGGGGGGGGGGGGGG
MMGGGGGGGGGGGGGGGGGGGGGGGGGG
MMGGGGGGGGGGGGGGGGGGGGGGGGGG
MMGGGGGGGGGGGGGGGGGGGGGGGGGG
MMGGGGGGGGGGGGGGGGGGGGGGGGGG
MMGGGGGGGGGGGGGGGGGGGGGGGGGG
MMGGGGGGGGGGGGGGGGGGGGGGGGGG
MMGGGGGGGGGGGGGGGGGGGGGGGGGG
MMGGGGGGGGGGGGGGGGGGGGGGGGGG
MMGGGGGGGGGGGGGGGGGGGGGGGGGG
MMGGGGGGGGGGGGGGGGGGGGGGGGGG
MMGGGGGGGGGGGGGGGGGGGGGGGGGG
MMGGGGGGGGGGGGGGGGGGGGGGGGGG
MMGGGGGGGGGGGGGGGGGGGGGGGGGG
MMGGGGGGGGGGGGGGGGGGGGGGGGGG
MMGGGGGGGGGGGGGGGGGGGGGGGGGG
MMGGGGGGGGGGGGGGGGGGGGGGGGGG
MMGGGGGGGGGGGGGGGGGGGGGGGGGG
[OVER]
...Q.Q......................
........QQ...Q.............Q
...........Q................
..QQQQ......................
............................
............................
.....Q......................
................QQQQQQQQQQ..
............................
..........................QQ
....................Q.......
............................
.....................QQQQQQQ
............................
............................
............................
............................
............................
............................
...........Q................
...Q...........Q............
............................
............................
............................
[ENTITY]
Skel skeletonDown.png 512 352
Skel2 skeletonDown.png 576 352



















