5_7.map
[RSC]
G grassDead.png
M rockyMountain.png
# waterToxic.png
W wall.png
R rubbleDead.png
S waterToxicWithStone.png
Q treeDyingTop.png
T treeDyingBottom.png
F treeDyingForest.png
[AT]
MMMQMQMMMMMMMMM...WWWWWWWWWW
MM.T.T..QQ...Q......W......Q
MM......FF.Q.F......W......F
MMQQQQ..FF.F.F......W......F
MMTTTT..TT.F.T......W......F
MM.........F........WWWWW..T
MM...Q.....FWW..............
MM...F.....F....QQQQQQQQQQ..
MM...F.....F....TTTTTTTTTF..
MM...T.....T.............TQQ
MM...WWWWWWWWWWWWWWWQ.....TT
MM..................F.......
MM..................FQQQQQQQ
MM###############...TTTTTTTT
MM###############...######.W
MM###############...######.W
MM###############...######.W
MM################.#######.W
MM################.#######.W
MM.........Q........######.W
MM.Q.......T...Q....######.W
MM.T...........T...........W
MM.........................W
MMWWWWWWWWWWWWWWWWWWWWWWWWWW
[UNDER]
MMMMMMMMMMMMMMMGGGGGGGGGGGGW
MMGGGGGGGGGGGGGGRGGGGGGGGGGG
MMGGGGGGGGGGGGGGGGGGGGGGGGGG
MMGGGGGGGGGGGGGGGGGGGGGGGGGG
MMGGGGGGGGGGGGGGGGGGGGGGGGGG
MMGGGGGGGGGGGGGGGGGGGGGGGGGG
MMGGGGGGGGGGGGGGGGGGGGGGGGGG
MMGGGGGGGGGGGGGGGGGGGGGGGGGG
MMGGGGGGGGGGGGGGGGGGGGGGGGGG
MMGGGGGGGGGGGGGGGGGGGGGGGGGG
MMGGGGGGGGGGGGGGGGGGGGGGGGGG
MMGGGGGGGGGGGGGGGGGGGGGGGGGG
MMGGGGGGGGGGGGGGGGGGGGGGGGGG
MMGGGGGGGGGGGGGGGGGGGGGGGGGG
MMGGGGGGGGGGGGGGGGGGGGGGGGGG
MMGGGGGGGGGGGGGGGGGGGGGGGGGG
MMGGGGGGGGGGGGGGGGGGGGGGGGGG
MMGGGGGGGGGGGGGGGGGGGGGGGGGG
MMGGGGGGGGGGGGGGGGGGGGGGGGGG
MMGGGGGGGGGGGGGGGGGGGGGGGGGG
MMGGGGGGGGGGGGGGGGGGGGGGGGGG
MMGGGGGGGGGGGGGGGGGGGGGGGGGG
MMGGGGGGGGGGGGGGGGGGGGGGGGGG
MMGGGGGGGGGGGGGGGGGGGGGGGGGG
[ENTITY]
Skel skeletonDown.png 512 352
Skel2 skeletonDown.png 576 352



















