5_8.map
[RSC]
G grassDead.png
M rockyMountain.png
# waterToxic.png
W wall.png
R rocks.png
T treeDyingBottom.png
Q treeDyingTop.png
F treeDyingForest.png

[AT]
MMWWWWWWWWWWWWWWWWWWWWWWWWWW
MM..................FWF.....
MM..WWWWWWWWWWWWWW..FWF....M
MM..W............W..TWT....M
MM...............W...W.....M
MM.....WWWWWWWW..WWWWWW....M
MM.....W.........W...W.....M
MM..F.FW.T.T.T...W..FWF....M
MM..T.FW............TWT....M
......FW...WWWWWWWWWWWW....M
......FW...WW..............M
....W.FW...WW..............M
MM..W.FW...WW..............M
MM..W.FW...WW..............M
MM....FW...WWWWWWWWWWWWWWWWM
MM....FW....................
MM..F.TW....................
MM..T..WWWWWWWWWWWWWWWWWWWWW
MM..........................
MM.###.................MMM..
MM.###.T.T.T.T.T.T.T...MMM..
MM.#################...MMM..
MM.#################...MMM.M
MMMMMMMMMMMMMMMMMMMMMMMM...M
[UNDER]
MMGGGGGGGGGGGGGGGGGGWWWWGGGG
MMGGGGGGGGGGGGGGGGGGGWGGGGGG
MMGGGGGGGGGGGGGGGGGGGGGGGGGG
MMGGGGGGGGGGGGGGGGGGGGGGGGGG
MMGGGGGGGGGGGGGGGGGGGGGGGGGG
MMGGGGGWGGGGGGGGGGGGGGGGGGGG
MMGGGGGGGGGGGGGGGGGGGGGGGGGG
MMGGGGGGGGGGGGGGGGGGGGGGGGGG
MMGGGGGGGGGGGGGGGGGGGGGGGGGG
GGGGGGGGGGGGGGGGGGGGGGGGGGGG
GGGGGGGGGGGGGGGGGGGGGGGGGGGG
GGGGGGGGGGGGGGGGGGGGGGGGGGGG
MMGGGGGGGGGGGGGGGGGGGGGGGGGG
MMGGGGGGGGGGGGGGGGGGGGGGGGGG
MMGGGGGGGGGGGGGGGGGGGGGGGGGG
MMGGGGGGGGGGGGGGGGGGGGGGGGGG
MMGGGGGGGGGGGGGGGGGGGGGGGGGG
MMGGGGGGGGGGGGGGGGGGGGGGGGGG
MMGGGGGGGGGGGGGGGGGGGGGGGGGG
MMGGGGGGGGGGGGGGGGGGGGGGGGGG
MMGGGGGGGGGGGGGGGGGGGGGGGGGG
MMGGGGGGGGGGGGGGGGGGGGGGGGGG
MMGGGGGGGGGGGGGGGGGGGGGGGGGG
MMGGGGGGGGGGGGGGGGGGGGGGGGGG
[OVER]
....................Q.Q.....
............................
............................
............................
............................
............................
....Q.Q..Q.Q.Q......Q.Q.....
............................
............................
............................
............................
............................
............................
............................
............................
....Q.......................
............................
............................
............................
.......Q.Q.Q.Q.Q.Q.Q........
............................
............................
............................
............................
[ENTITY]
Skel skeletonDown.png 512 352
Skel2 skeletonDown.png 576 352



















