5_9.map
[RSC]
G grassDead.png
M rockyMountain.png
# waterToxic.png
W wall.png
R rubbleDead.png
T treeDyingBottom.png
Q treeDyingTop.png
F treeDyingForest.png
[AT]
MMMMMMMMMMMMMMMMMMMMMMMM...M
MMMMMMMMMMMMMMMMMMMMMMMM...M
MMMMMMMMMMMMMMMMMMMMMMM....M
MM.............MMMMMMMM....M
MM..#########....MMMMMM....M
MM.##########....MMMMMQ....M
MM.######..###...QMMMQT....M
MM..Q####........TMMQT....MM
MM..T#####........MMT....MMM
MM....Q####QQQQQ.......QMMMM
MMM...T####TTFFFQQQQQQQFMMMM
MMMM.........TTFFFFFFFTTMMMM
MMMMM..........TTFFFFF......
MM..MMM..........TFFFT......
MMQ..MMM..........FFF.....QQ
MMT............Q..FFF....QFF
MM...MMM.......T..FFF..Q.TFF
MM..MMM...........FFF..T..TF
MMMMM............QFFFQ.....T
MMM.............QFFFFFQ.....
MMM.............TTTTTTT.....
MMMM........................
MMMMMMMMMMMMMMMMMMMMMMMMMMMM
MMMMMMMMMMMMMMMMMMMMMMMMMMMM
[UNDER]
MMGGGGGGGGGGGGGGGGGGGGGGGGGM
MMGGGGGGGGGGGGGGGGGGGGGGGGGM
MMGGGGGGGGGGGGGGGGGGGGGGGGGM
MMGGGGGGGGGGGGGGGGGGGGGGGGGM
MMGGGGGGGGGGGGGGGGGGGGGGGGGM
MMGGGGGGGGGGGGGGGMMMMMMGGGGM
MMGGGGGGGGGGGGGGGMMMMMGGGGGM
MMGGGGGGGGGGGGGGGGMMMGGGGGGM
MMGGGGGGGGGGGGGGGGGGGGGGGGGM
MMGGGGGGGGGGGGGGGGGGGGGGGGGM
MMGGGGGGGGGGGGGGGGGGGGGGGGGM
MMGGGGGGGGGGGGGGGGGGGGGGMMMM
MMGGGGGGGGGGGGGGGGGGGGGGGGGG
MMGGGGGGGGGGGGGGGGGGGGGGGGGG
MMGGGGGGGGGGGRGGGGGGGGGGGGGG
MMGGGGGGGGGGGGGGGGGGGGGGGGGG
MMGGGGGGGGGGGGGGGGGGGGGGGGGG
MMGGGGGGGGGGGGRGGGGGGGGGGGGG
MMGGGGGGGGGGGGGGGGGGGGGGGGGG
MMGGGGGGRGGGGGGGGGGGGGGGGGGG
MMGGGGGGGGGGGGGGGGGGGGGGGGGG
MMGGGGGGGGGGGGGGGGGGGGGGGGGG
MMGGGGGGGGGGGGGGGGGGGGGGGGGG
MMGGGGGGGGGGGGGGGGGGGGGGGGGG
[ENTITY]
Skel skeletonDown.png 320 480
Skel2 skeletonDown.png 320 512



















