5_9.map
[RSC]
G grassDead.png
M rocks.png
# waterToxic.png
W wall.png
R rubbleDead.png
T treeDyingBottom.png
Q treeDyingTop.png
[AT]
MMMMMMMMMMMMMMMMMMMMMMM....M
MMMMMMMMMMMMMMMMMMMMMMM....M
MMMMMMMMMMMMMMMMMMMMMMM....M
MM.............MMMMMMMM....M
MM..#########....MMMMMM....M
MM.##########....MMMMMQ....M
MM.######..###...QMMMQT....M
MM..Q####........TMMQT....MM
MM..T#####........MMT....MMM
MM....Q####QQQQQ.......QMMMM
MMM...T####TTQQQQQQQQQQQMMMM
MMMM.........TTQQQQQQQTTMMMM
MMMMM..........TTQQQQQ......
MM..MMM..........TQQQT......
MMQ..MMM..........QQQ.....QQ
MMT............Q..QQQ....QQQ
MM...MMM.......T..QQQ..Q.TQQ
MM..MMM...........QQQ..T..TQ
MMMMM............QQQQQ.....T
MMM.............QQQQQQQ.....
MMM.............TTTTTTT.....
MMMM........................
MMMMMMMMMMMMMMMMMMMMMMMMMMMM
MMMMMMMMMMMMMMMMMMMMMMMMMMMM
[UNDER]
MMGGGGGGGGGGGGGGGGGGGGGGGGGM
MMGGGGGGGGGGGGGGGGGGGGGGGGGM
MMGGGGGGGGGGGGGGGGGGGGGGGGGM
MMGGGGGGGGGGGGGGGGGGGGGGGGGM
MMGGGGGGGGGGGGGGGGGGGGGGGGGM
MMGGGGGGGGGGGGGGGMMMMMMGGGGM
MMGGGGGGGGGGGGGGGMMMMMGGGGGM
MMGGGGGGGGGGGGGGGGMMMGGGGGGM
MMGGGGGGGGGGGGGGGGGGGGGGGGGM
MMGGGGGGGGGGGGGGGGGGGGGTGGGM
MMGGGGGGGGGGGTTTGGGGGGGTGGGM
MMGGGGGGGGGGGTTTGGGGGGGGMMMM
MMGGGGGGGGGGGGGTTTTTTTGGGGGG
MMGGGGGGGGGGGGGGGTTTTTGGGGGG
MMGGGGGGGGGGGRGGGGTTTGGGGGTT
MMGGGGGGGGGGGGGGGGTTTGGGGTTT
MMGGGGGGGGGGGGGGGGTTTGGGGGTT
MMGGGGGGGGGGGGRGGGTTTGGGGGGT
MMGGGGGGGGGGGGGGGTTTTTGGGGGG
MMGGGGGGRGGGGGGGTTTTTTTGGGGG
MMGGGGGGGGGGGGGGGGGGGGGGGGGG
MMGGGGGGGGGGGGGGGGGGGGGGGGGG
MMGGGGGGGGGGGGGGGGGGGGGGGGGG
MMGGGGGGGGGGGGGGGGGGGGGGGGGG
[ENTITY]
Skel skeletonDown.png 320 480
Skel2 skeletonDown.png 320 512



















