5_9.map
[RSC]
G grassDead.png
M rockyMountain.png
# waterToxic.png
W wall.png
R rubbleDead.png
T treeDyingBottom.png
Q treeDyingTop.png
F treeDyingForest.png
[AT]
MMMMMMMMMMMMMMMMMMMMMMMM...M
MMMMMMMMMMMMMMMMMMMMMMMM...M
MMMMMMMMMMMMMMMMMMMMMMM....M
MM.............MMMMMMMM....M
MM..#########....MMMMMM....M
MM.##########....MMMMMM....M
MM.######..###...MMMMMT....M
MM...####........TMMMT....MM
MM..T#####........MMT....MMM
MM.....####.............MMMM
MMM...T####TTFFF.......FMMMM
MMMM.........TTFFFFFFFTTMMMM
MMMMM..........TTFFFFF......
MM..MMM..........TFFFT......
MM...MMM..........FFF.......
MMT...............FFF.....FF
MM...MMM.......T..FFF....TFF
MM..MMM...........FFF..T..TF
MMMMM.............FFF......T
MMM..............FFFFF......
MMM.............TTTTTTT.....
MMMM........................
MMMMMMMMMMMMMMMMMMMMMMMMMMMM
MMMMMMMMMMMMMMMMMMMMMMMMMMMM
[UNDER]
MMGGGGGGGGGGGGGGGGGGGGGGGGGM
MMGGGGGGGGGGGGGGGGGGGGGGGGGM
MMGGGGGGGGGGGGGGGGGGGGGGGGGM
MMGGGGGGGGGGGGGGGGGGGGGGGGGM
MMGGGGGGGGGGGGGGGGGGGGGGGGGM
MMGGGGGGGGGGGGGGGMMMMMMGGGGM
MMGGGGGGGGGGGGGGGMMMMMGGGGGM
MMGGGGGGGGGGGGGGGGMMMGGGGGGM
MMGGGGGGGGGGGGGGGGGGGGGGGGGM
MMGGGGGGGGGGGGGGGGGGGGGGGGGM
MMGGGGGGGGGGGGGGGGGGGGGGGGGM
MMGGGGGGGGGGGGGGGGGGGGGGMMMM
MMGGGGGGGGGGGGGGGGGGGGGGGGGG
MMGGGGGGGGGGGGGGGGGGGGGGGGGG
MMGGGGGGGGGGGRGGGGGGGGGGGGGG
MMGGGGGGGGGGGGGGGGGGGGGGGGGG
MMGGGGGGGGGGGGGGGGGGGGGGGGGG
MMGGGGGGGGGGGGRGGGGGGGGGGGGG
MMGGGGGGGGGGGGGGGGGGGGGGGGGG
MMGGGGGGRGGGGGGGGGGGGGGGGGGG
MMGGGGGGGGGGGGGGGGGGGGGGGGGG
MMGGGGGGGGGGGGGGGGGGGGGGGGGG
MMGGGGGGGGGGGGGGGGGGGGGGGGGG
MMGGGGGGGGGGGGGGGGGGGGGGGGGG
[OVER]
............................
............................
............................
............................
............................
......................Q.....
.................Q...Q......
....Q...............Q.......
............................
......Q....QQQQQ.......Q....
................QQQQQQQ.....
............................
............................
............................
..Q.......................QQ
...............Q.........Q..
.......................Q....
............................
.................Q...Q......
................Q.....Q.....
............................
............................
............................
............................
[ENTITY]
Skel skeletonDown.png 320 480
Skel2 skeletonDown.png 320 512



















