Tile6_2
[RSC]
G grass.png
M rockyMountain.png
s sand.png
r rubble.png
O water.png
[AT]
....................OOOOOOOO
.....................OOOOOOO
.....................OOOOOOO
......................OOOOOO
......................OOOOOO
......................OOOOOO
.......................OOOOO
.......................OOOOO
.......................OOOOO
.......................OOOOO
........................OOOO
........................OOOO
........................OOOO
.........................OOO
.........................OOO
.........................OOO
..........................OO
..........................OO
rrrrrr....................OO
.....r....................OO
.....r....................OO
.....r....................OO
.....r....................OO
.....r....................OO
[UNDER]
GGGGGGGGGGGGGGGGGsss........
GGGGGGGGGGGGGGGGGGsss.......
GGGGGGGGGGGGGGGGGGGss.......
GGGGGGGGGGGGGGGGGGGsss......
GGGGGGGGGGGGGGGGGGGGss......
GGGGGGGGGGGGGGGGGGGGss......
GGGGGGGGGGGGGGGGGGGGsss.....
GGGGGGGGGGGGGGGGGGGGGss.....
GGGGGGGGGGGGGGGGGGGGGss.....
GGGGGGGGGGGGGGGGGGGGGss.....
GGGGGGGGGGGGGGGGGGGGGsss....
GGGGGGGGGGGGGGGGGGGGGGss....
GGGGGGGGGGGGGGGGGGGGGGss....
GGGGGGGGGGGGGGGGGGGGGGsss...
GGGGGGGGGGGGGGGGGGGGGGGss...
GGGGGGGGGGGGGGGGGGGGGGGsss..
GGGGGGGGGGGGGGGGGGGGGGGGssss
GGGGGGGGGGGGGGGGGGGGGGGGssss
......GGGGGGGGGGGGGGGGGGssGG
GGGGG.GGGGGGGGGGGGGGGGGGssGG
GGGGG.GGGGGGGGGGGGGGGGGGssGG
GGGGG.GGGGGGGGGGGGGGGGGGssGG
GGGGG.GGGGGGGGGGGGGGGGGGssGG
GGGGG.GGGGGGGGGGGGGGGGGGssGG
[ENTITY]
