Tile6_3
[RSC]
s sand.png
O water.png
G grass.png
r rubble.png
[AT]
.....r....................OO
.....r....................OO
.....r....................OO
.....rrr...................O
............................
......r..............r......
rrrrrrrr.....r..............
............................
..................r.........
......................r.....
r...........................
r..........r.......r........
r...........................
r...........................
r....r...........r..........
r............r..............
r..........rrr.rrrrrr.r.....
...........r....r.....r.....
...........r........rrr.....
.....r.....r..r.............
.......r...r.......r..r.....
...........r..r.......r.....
...........r..r.............
...........r............r...
[UNDER]
GGGGGGGGGGGGGGGGGGGGGGGGssss
GGGGGGGGGGGGGGGGGGGGGGGGssss
GGGGGGGGGGGGGGGGGGGGGGGGssss
GGGGGGGGGGGGGGGGGGGGGGGGGsss
GGGGGGGGGGGGGGGGGGGGGGGGGsss
GGGGGGGGGGGGGGGGGGGGGGGGGGss
GGGGGGGGGGGGGGGGGGGGGGGGGGGG
GGGGGGGGGGGGGGGGGGGGGGGGGGGG
GGGGGGGGGGGGGGGGGGGGGGGGGGGG
GGGGGGGGGGGGGGGGGGGGGGGGGGGG
GGGGGGGGGGGGGGGGGGGGGGGGGGGG
GGGGGGGGGGGGGGGGGGGGGGGGGGGG
GGGGGGGGGGGGGGGGGGGGGGGGGGGG
GGGGGGGGGGGGGGGGGGGGGGGGGGGG
GGGGGGGGGGGGGGGGGGGGGGGGGGGG
GGGGGGGGGGGGGGGGGGGGGGGGGGGG
GGGGGGGGGGGGGGGGGGGGGGGGGGGG
GGGGGGGGGGGGGGGGGGGGGGGGGGGG
GGGGGGGGGGGGGGGGGGGGGGGGGGGG
GGGGGGGGGGGGGGGGGGGGGGGGGGGG
GGGGGGGGGGGGGGGGGGGGGGGGGGGG
GGGGGGGGGGGGGGGGGGGGGGGGGGGG
GGGGGGGGGGGGGGGGGGGGGGGGGGGG
GGGGGGGGGGGGGGGGGGGGGGGGGGGG
[ENTITY]
skeleton skeletonDown.png 128 128
skeleton skeletonDown.png 608 608

