6_6.map
[RSC]
G grassDead.png
M rockyMountain.png
# water.png
s waterWithStone.png
W wall.png
T treeDyingBottom.png
Q treeDyingTop.png
R rubbleDead.png
[AT]
MM.......WWWWWWWWWWWWWWWWWWW
MM..........................
MM..........................
MM.......W..................
MM.......W..................
MM.......W..................
MM.......W..................
MM.T.T.T.W..................
MM######.###################
MM######.###################
MM######.###################
MM######.###################
MM######.###################
MM######.###################
MM######..............######
MM###################.######
MM###################.######
MM###################.######
MM###################.######
MM###################.######
MM.................MM......M
MM.................MM.....MM
MMMMMMMMMMMMMMMMMMMMM...MMMM
MMMMMMMMMMMMMMMMMMMMM...MMMM
[UNDER]
MMGGGGGGGGGGGGGGGGGGGGGGGGGG
MMGRGGGGGGGGGGGGGGGGGGGGGGGG
MMGGGGGGGGGGGGGGGGGGGGGGGGGG
MMGGGGGGGGGGGGGGGGGGGGGGGGGG
MMGGGRGGGGGGGGGGGGGGGGGGGGGG
MMGGGGGGGGGGGGGGGGGGGGGGGGGG
MMGGGGGGGGGGGGGGGGGGGGGGGGGG
MMGGGGGGGGGGGGGGGGGGGGGGGGGG
MM######s###################
MM######s###################
MM######s###################
MM######s###################
MM######s###################
MM######s###################
MM######ssssssssssssss######
MM###################s######
MM###################s######
MM###################s######
MM###################s######
MM###################s######
GGGGGGGGGGGGGGGGGGGGGGGGGGGG
GGGGGGGGGGGGGGGGGGGGGGGGGGGG
MMMMMMMMMMMMMMMMMMMMMGGGMMMM
MMMMMMMMMMMMMMMMMMMMMGGGMMMM
[OVER]
............................
............................
............................
............................
............................
............................
...Q.Q.Q....................
............................
............................
............................
............................
............................
............................
............................
............................
............................
............................
............................
............................
............................
............................
............................
............................
............................
[ENTITY]
Skel skeletonDown.png 480 128
Skel2 skeletonDown.png 576 128
Skel3 skeletonDown.png 672 128



















