6_7.map
[RSC]
G grassDead.png
M rockyMountain.png
# waterToxic.png
W wall.png
R rubbleDead.png
T treeDyingBottom.png
Q treeDyingTop.png
H barHedgeDead.png
F treeDyingForest.png
[AT]
MMMMMMMMMMMMMMMMMMMMM...MMMM
MMMMMMMMMMMMMMMMMMMMM...MMMM
MMM.....................MMMM
M.....T..TTT..T.......TTMMMM
F...FT..........TTTTTT..MMMM
F...F...........W...WW..MMMM
TT.TT.T.................MMMM
........FF.......WWWWWWWMMMM
........FF.TTTTTT.......MMMM
...TTTTTTTT.............MMMM
WWWWWWWWW...............MMMM
..................TTT...MMMM
...........FFFTTTT......MMMM
F...MMMMTFFFFF..........MMMM
FHHMMMMMMFFFTT......MMMMMMMM
F####MMMMTFF.....MMMMMMMMMMM
F#####MMMMFT.....MMM....MMMM
F.###MM...T...MMMMM..T..MMMM
FFM##MMTTT...MMMMM.....MMMMM
TTMMMMMMMM...MMMM....MMMMMMM
MMMM..MMMM....MMM...MM..MMMM
MMM......MM...MMM...MM..MMMM
MMM.......MM...MM...MM..MMMM
WWWW..F...MM...MM...MM..MMMM
[UNDER]
GGGGGGGGGGGGGGGGGGGGGGGGGGGG
GGGGGGGGGGGGGGGGGGGGGGGGGGGG
GGGGGGGGGGGGGGGGGGGGGGGGGGGG
GGGGGGGGGGGGGGGGGGGGGGGGGGGG
GGGGGGGGGGGGGGGGGGGGGGGGGGGG
GGGGGGGGGGGGGGGGGGGGGGGGGGGG
GGGGGGGGGGGGGGGGGGGGGGGGGGGG
GGGGGGGGGGGGGGGGGGGGGGGGGGGG
GGGGGGGGGGGGGGGGGGGGGGGGGGGG
GGGGGGGGGGGGGGGGGGGGGGGGGGGG
GGGGGGGGGGGGGGGGGGGGGGGGGGGG
GGGGGGGGGGGGGGGGGGGGGGGGGGGG
GGGGGGGGGGGGGGGGGGGGGGGGGGGG
GGGGGGGGGGGGGGGGGGGGGGGGGGGG
GGGGGGGGGGGGGGGGGGGGGGGGGGGG
GGGGGGGGGGGGGGGGGGGGGGGGGGGG
GGGGGGGGGGGGGGGGGGGGGGGGGGGG
GGGGGGGGGGGGGGGGGGGGGGGGGGGG
GGGGGGGGGGGGGGGGGGGGGGGGGGGG
GGGGGGGGGGGGGGGGGGGGGGGGGGGG
GGGGGGGGGGGGGGGGGGGGGGGGGGGG
GGGGGGGGGGGGGGGGGGGGGGGGGGGG
GGGGGGGGGGGGGGGGGGGGGGGGGGGG
GGGGGGGGGGGGGGGGGGGGGGGGGGGG
[OVER]
............................
............................
......Q..QQQ..Q.......QQ....
Q...QQ..........QQQQQQ......
............................
.Q.Q..Q.....................
........QQ..................
...........QQQQQQ...........
...QQQQQ..Q.................
............................
..................QQQ.......
...........QQQQQQQ..........
Q.......QQQ.................
............................
............................
............................
.....................Q......
.Q.....QQQ..................
............................
............................
............................
............................
......Q.....................
............................
[ENTITY]
Skel skeletonDown.png 320 320


















