6_7.map
[RSC]
G grassDead.png
M rockyMountain.png
# waterToxic.png
W wall.png
R rubbleDead.png
T treeDyingBottom.png
Q treeDyingTop.png
H barHedgeDead.png
F treeDyingForest.png
[AT]
MMMMMMMMMMMMMMMMMMMMM...MMMM
MMMMMMMMMMMMMMMMMMMMM...MMMM
MMM...Q..QQQ..Q.......QQMMMM
Q...QQT..TTT..T.QQQQQQTTMMMM
F...FT..........TTTTTT..MMMM
FQ.QF.Q.........W...WW..MMMM
TT.TT.T.QQ..............MMMM
........FF.QQQQQQWWWWWWWMMMM
...QQQQQFFQTTTTTT.......MMMM
...TTTTTTTT.............MMMM
WWWWWWWWW.........QQQ...MMMM
...........QQQQQQQTTT...MMMM
Q.......QQQFFFTTTT......MMMM
F...MMMMTFFFFF..........MMMM
FHHMMMMMMFFFTT......MMMMMMMM
F####MMMMTFF.....MMMMMMMMMMM
F#####MMMMFT.....MMM.Q..MMMM
FQ###MMQQQT...MMMMM..T..MMMM
FFM##MMTTT...MMMMM.....MMMMM
TTMMMMMMMM...MMMM....MMMMMMM
MMMM..MMMM....MMM...MM..MMMM
MMM......MM...MMM...MM..MMMM
MMM...Q...MM...MM...MM..MMMM
WWWW..T...MM...MM...MM..MMMM
[UNDER]
GGGGGGGGGGGGGGGGGGGGGGGGGGGG
GGGGGGGGGGGGGGGGGGGGGGGGGGGG
GGGGGGGGGGGGGGGGGGGGGGGGGGGG
GGGGGGGGGGGGGGGGGGGGGGGGGGGG
GGGGGGGGGGGGGGGGGGGGGGGGGGGG
GGGGGGGGGGGGGGGGGGGGGGGGGGGG
GGGGGGGGGGGGGGGGGGGGGGGGGGGG
GGGGGGGGGGGGGGGGGGGGGGGGGGGG
GGGGGGGGGGGGGGGGGGGGGGGGGGGG
GGGGGGGGGGGGGGGGGGGGGGGGGGGG
GGGGGGGGGGGGGGGGGGGGGGGGGGGG
GGGGGGGGGGGGGGGGGGGGGGGGGGGG
GGGGGGGGGGGGGGGGGGGGGGGGGGGG
GGGGGGGGGGGGGGGGGGGGGGGGGGGG
GGGGGGGGGGGGGGGGGGGGGGGGGGGG
GGGGGGGGGGGGGGGGGGGGGGGGGGGG
GGGGGGGGGGGGGGGGGGGGGGGGGGGG
GGGGGGGGGGGGGGGGGGGGGGGGGGGG
GGGGGGGGGGGGGGGGGGGGGGGGGGGG
GGGGGGGGGGGGGGGGGGGGGGGGGGGG
GGGGGGGGGGGGGGGGGGGGGGGGGGGG
GGGGGGGGGGGGGGGGGGGGGGGGGGGG
GGGGGGGGGGGGGGGGGGGGGGGGGGGG
GGGGGGGGGGGGGGGGGGGGGGGGGGGG
[ENTITY]
Skel skeletonDown.png 320 320


















