6_8.map
[RSC]
G grassDead.png
M rockyMountain.png
# waterToxic.png
W wall.png
R rubbleDead.png
T treeDyingBottom.png
Q treeDyingTop.png
F treeDyingForest.png
[AT]
WWWW..Q...MM...QQ...QQ..MMMM
......F...MM...FF...FF..MMMM
MMMM..F...MM...FF...FF..MMMM
MMMMQQF...QQ...FF...FF..MMMM
MMMMFFT...FF...FF...FF..MMMM
MMMMFF....FF...FF...TT..MMMM
MMMMTF....FF...FFQ......MMMM
MMMMMF...QFFQ..TTT......MMMM
MMMMMT..QFFFTQ...QQQ...QMMMM
MMMMMM..TFFF.T...TTT...TMMMM
MMMMMM...TTT...........QMMMM
MMMMMM.................TMMMM
MMMMMM..Q.Q..MMMMMMMM..QMMMM
MMMMMMMMT.T...MMMMMM...TMMMM
MMMMMMMMM.MM...MMMM....QMMMM
.....MMMM.MMM..........TMMMM
.QQ...MMM.MMMM..........MMMM
WTF..MMMM.MMMMMM########MMMM
..T..MM.....MMMMMM####MMMMMM
.....MMQ.....MMMMMMM##MMMMMM
.....MMT.....QQ..MMMMMMMMMMM
....MMMMQ....TT....MMMMMMMMM
MMMMMMMMT............MMMMMMM
MMMMMMMMMM..............MMMM
[UNDER]
MMGGGGGGGGGGGGGGGGGGGGGGGGGG
GGGGGGGGGGGGGGGGGGGGGGGGGGGG
MMGGGGGGGGGGGGGGGGGRGGGGGGGG
MMGGGGGGGGMMGGGGGGGGGGGGGGGG
MMGGGGGGGGGGGGGGGGGGGGGGGGGG
MMGGGGGGGGGGGGGGGGGGGGGGGGGG
MMGGGGGGGGGGGGGGGGGGGGGGGGGG
MMGGGGGGGGGGGGGGGGGGGGGGGGGG
MMGGGGGGGGGGGGGGGGGGGGGGGGGG
MMGGGGGGGGGGGGGGGGGGGGGGGGGG
MMGGGGGGGGGGGGGGGGGGGGGGGGGG
MMGGGGGGGGGGGGGGGGGGGGGGGGGG
MMGGGGGGGGGGGGGGGGGGGGGGGGGG
MMGGGGGGGGGGGGGGGGGGGGGGGGGG
GGGGGGGGGGGGGGGGGGGGGGGGGGGG
GGGGGGGGGGGGGGGGGGGGGGGGGGGG
GGGGGGGGGGGGGGGGGGGGGGGGGGGG
GGGGGGGGGGGGGGGGGGGGGGGGGGGG
GGGGGGGGGGGGGGGGGGGGGGGGGGGG
GGGGGGGGGGGGGGGGGGGGGGGGGGGG
GGGGGGGGGGGRGGGGGGGGGGGGGGGG
GGGGGGGGGGGGGGGGGGGGGGGGGGGG
MMGRGGGGGGGGGGGGGGGGGGGGGGGG
MMGGGGGGGGGGGGGGGGGGGGGGGGGG
[ENTITY]
Skel skeletonDown.png 416 32
Skel skeletonDown.png 576 32
Skel skeletonDown.png 704 32


















