6_8.map
[RSC]
G grassDead.png
M rockyMountain.png
# waterToxic.png
W wall.png
R rubbleDead.png
T treeDyingBottom.png
Q treeDyingTop.png
F treeDyingForest.png
[AT]
WWWW..F...MM...MM...MM..MMMM
......F...MM...FF...FF..MMMM
MMMM..F...MM...FF...FF..MMMM
MMMM..F........FF...FF..MMMM
MMMMFFT...FF...FF...FF..MMMM
MMMMFF....FF...FF...TT..MMMM
MMMMTF....FF...FF.......MMMM
MMMMMF....FF...TTT......MMMM
MMMMMT...FFFT...........MMMM
MMMMMM..TFFF.T...TTT...TMMMM
MMMMMM...TTT............MMMM
MMMMMM.................TMMMM
MMMMMM.......MMMMMMMM...MMMM
MMMMMMMMT.T...MMMMMM...TMMMM
MMMMMMMMM.MM...MMMM.....MMMM
.....MMMM.MMM..........TMMMM
......MMM.MMMM..........MMMM
WTF..MMMM.MMMMMM########MMMM
..T..MM.....MMMMMM####MMMMMM
.....MM......MMMMMMM##MMMMMM
.....MMT.........MMMMMMMMMMM
....MMMM.....TT....MMMMMMMMM
MMMMMMMMT............MMMMMMM
MMMMMMMMMM..............MMMM
[UNDER]
MMGGGGGGGGGGGGGGGGGGGGGGGGGG
GGGGGGGGGGGGGGGGGGGGGGGGGGGG
MMGGGGGGGGGGGGGGGGGRGGGGGGGG
MMGGGGGGGGMMGGGGGGGGGGGGGGGG
MMGGGGGGGGGGGGGGGGGGGGGGGGGG
MMGGGGGGGGGGGGGGGGGGGGGGGGGG
MMGGGGGGGGGGGGGGGGGGGGGGGGGG
MMGGGGGGGGGGGGGGGGGGGGGGGGGG
MMGGGGGGGGGGGGGGGGGGGGGGGGGG
MMGGGGGGGGGGGGGGGGGGGGGGGGGG
MMGGGGGGGGGGGGGGGGGGGGGGGGGG
MMGGGGGGGGGGGGGGGGGGGGGGGGGG
MMGGGGGGGGGGGGGGGGGGGGGGGGGG
MMGGGGGGGGGGGGGGGGGGGGGGGGGG
GGGGGGGGGGGGGGGGGGGGGGGGGGGG
GGGGGGGGGGGGGGGGGGGGGGGGGGGG
GGGGGGGGGGGGGGGGGGGGGGGGGGGG
GGGGGGGGGGGGGGGGGGGGGGGGGGGG
GGGGGGGGGGGGGGGGGGGGGGGGGGGG
GGGGGGGGGGGGGGGGGGGGGGGGGGGG
GGGGGGGGGGGRGGGGGGGGGGGGGGGG
GGGGGGGGGGGGGGGGGGGGGGGGGGGG
MMGRGGGGGGGGGGGGGGGGGGGGGGGG
MMGGGGGGGGGGGGGGGGGGGGGGGGGG
[OVER]
...............QQ...QQ......
............................
............................
....QQ....QQ................
............................
............................
.................Q..........
.........Q..Q...............
........Q....Q...QQQ...Q....
............................
.......................Q....
............................
........Q.Q............Q....
............................
.......................Q....
............................
.QQ.........................
............................
............................
.......Q....................
.............QQ.............
........Q...................
............................
............................
[ENTITY]
Skel skeletonDown.png 416 32
Skel skeletonDown.png 576 32
Skel skeletonDown.png 704 32


















