6_9.map
[RSC]
G grassDead.png
M rockyMountain.png
# waterToxic.png
W wall.png
R rubbleDead.png
T treeDyingBottom.png
Q treeDyingTop.png
F treeDyingForest.png
[AT]
MMMMMMMMMM..............MMMM
MMMMMM..................MMMM
MMMM..........T.........MMMM
MMM.....####............MMMM
MMMM.T.######....T......MMMM
MMMMM###########........MMMM
MMMMMMM##########.......MMMM
MMMMMMMMMM########......MMMM
MMMMMMMMMMMM########....MMMM
MMMMMMMMMMMM########....MMMM
MMMMMMMMMMMM########....MMMM
MMMMMMMMMMMM########....MMMM
.............######.....MMMM
...T.T.T.T.T..####.....TMMMM
...............##.......MMMM
MMM....................TMMMM
MMMM....................MMMM
MMMMM...T.T.T.....T.T..TMMMM
TTTTT..................MMMMM
.....TF................MMMMM
......F....TTTTTTT....MMMMMM
......TT............MMMMMMMM
MMMMMMMMMMMMMMMMMMMMMMMMMMMM
MMMMMMMMMMMMMMMMMMMMMMMMMMMM
[UNDER]
MMGGGGGGGGGGGGGGGGGGGGGGGGGG
MMGGGGGGGGGGGGGGGGGGGGGGGGGG
MMGGGGGGGGGGGGGGGGGRGGGGGGGG
MMGGGGGGGGGGGGGGGGGGGGGGGGGG
MMGGGGGGGGGGGGGGGGGGGGGGGGGG
MMGGGGGGGGGGGGGGGGGGGGGGGGGG
MMGGGGGGGGGGGGGGGGGGGGGGGGGG
MMGGGGGGGGGGGGGGGGGGGGGGGGGG
MMGGGGGGGGGGGGGGGGGGGGGGGGGG
MMGGGGGGGGGGGGGGGGGGGGGGGGGG
MMGGGGGGGGGGGGGGGGGGGGGGGGGG
MMGGGGGGGGGGGGGGGGGGGGGGGGGG
GGGGGGGGGGGGGGGGGGGGGGGGGGGG
GGGGGGGGGGGGGGGGGGGGGGGGGGGG
GGGGGGGGGGGGGGGGGGGGGGGGGGGG
MMGGGGGGGGGGGGGGGGGGGGGGGGGG
MMGGGGGGGGGGGGGGGGGGGGGGGGGG
MMGGGGGGGGGGGGGGGGGGGGGGGGGG
MMGGGGGGGGGGGGGGGGGGGGGGGGGG
GGGGGGGGGGGGGGGGGGGGGGGGGGGG
GGGGGGGGGGGGGGGGGGGGGGGGGGGG
GGGGGGGGGGGGGGGGGGGGGGGGGGGG
MMGRGGGGGGGGGGGGGGGGGGGGGGGG
MMGGGGGGGGGGGGGGGGGGGGGGGGGG
[OVER]
............................
..............Q.............
............................
.....Q...........Q..........
............................
............................
............................
............................
............................
............................
............................
............................
...Q.Q.Q.Q.Q...........Q....
............................
.......................Q....
............................
........Q.Q.Q.....Q.Q..Q....
QQQQQ.......................
.....QQ.....................
...........QQQQQQQ..........
.......Q....................
............................
............................
............................
[ENTITY]
Skel skeletonDown.png 320 480
Skel2 skeletonDown.png 320 512



















