6_9.map
[RSC]
G grassDead.png
M rocks.png
# waterToxic.png
W wall.png
R rubbleDead.png
T treeDyingBottom.png
Q treeDyingTop.png
[AT]
MMMMMMMMMM..............MMMM
MMMMMM........Q.........MMMM
MMMM..........T.........MMMM
MMM..Q..####.....Q......MMMM
MMMM.T.######....T......MMMM
MMMMM###########........MMMM
MMMMMMM##########.......MMMM
MMMMMMMMMM########......MMMM
MMMMMMMMMMMM########....MMMM
MMMMMMMMMMMM########....MMMM
MMMMMMMMMMMM########....MMMM
MMMMMMMMMMMM########....MMMM
...Q.Q.Q.Q.Q.######....QMMMM
...T.T.T.T.T..####.....TMMMM
MM.............##......QMMMM
MMMM...................TMMMM
MMMM....Q.Q.Q.....Q.Q..QMMMM
QQQQQ...T.T.T.....T.T..TMMMM
TTTTTQQ................MMMMM
.....TT....QQQQQQQ.....MMMMM
......QQ...TTTTTTT....MMMMMM
......TT............MMMMMMMM
MMMMMMMMMMMMMMMMMMMMMMMMMMMM
MMMMMMMMMMMMMMMMMMMMMMMMMMMM
[UNDER]
MMGGGGGGGGGGGGGGGGGGGGGGGGGG
MMGGGGGGGGGGGGGGGGGGGGGGGGGG
MMGGGGGGGGGGGGGGGGGRGGGGGGGG
MMGGGGGGGGGGGGGGGGGGGGGGGGGG
MMGGGGGGGGGGGGGGGGGGGGGGGGGG
MMGGGGGGGGGGGGGGGGGGGGGGGGGG
MMGGGGGGGGGGGGGGGGGGGGGGGGGG
MMGGGGGGGGGGGGGGGGGGGGGGGGGG
MMGGGGGGGGGGGGGGGGGGGGGGGGGG
MMGGGGGGGGGGGGGGGGGGGGGGGGGG
MMGGGGGGGGGGGGGGGGGGGGGGGGGG
MMGGGGGGGGGGGGGGGGGGGGGGGGGG
GGGGGGGGGGGGGGGGGGGGGGGGGGGG
GGGGGGGGGGGGGGGGGGGGGGGGGGGG
MMGGGGGGGGGGGGGGGGGGGGGGGGGG
MMGGGGGGGGGGGGGGGGGGGGGGGGGG
MMGGGGGGGGGGGGGGGGGGGGGGGGGG
MMGGGGGGGGGGGGGGGGGGGGGGGGGG
MMGGGGGGGGGGGGGGGGGGGGGGGGGG
GGGGGGGGGGGGGGGGGGGGGGGGGGGG
GGGGGGGGGGGGGGGGGGGGGGGGGGGG
GGGGGGGGGGGGGGGGGGGGGGGGGGGG
MMGRGGGGGGGGGGGGGGGGGGGGGGGG
MMGGGGGGGGGGGGGGGGGGGGGGGGGG
[ENTITY]
Skel skeletonDown.png 320 480
Skel2 skeletonDown.png 320 512



















