Tile7_4
[RSC]
W wall.png
M rockyMountain.png
G grass.png
[AT]
................MMMMMMMM....
................MMMMMMMM....
.................MMMMMMM....
..................MMMMMM....
...................MMMMMM...
....................MMMMMM..
......................MMMMMM
........................MMMM
..........................MM
..........................MM
...........................M
............................
MMMMMMMMMMMMMMMM............
MMMMMMMMMMMMMMMM............
MMMMMMMMMMMMMMMM............
MMMMMMMMMMMMMMMMM...........
MMMMMMMMMMMMMMMMM...........
MMMMMMMMMMMMMMMMM...........
MMMMMMMMMMMMMMMMMMM.........
MMMMMMMMMMMMMMMMMMMM........
MMMMMMMMMMMMMMMMMMMM........
MMMMMMMMMMMMMMMMMMMM........
MMMMMMMMMMMMMMMMMMMMMMMMMMMM
MMMMMMMMMMMMMMMMMMMMMMMMMMMM
[UNDER]
GGGGGGGGGGGGGGGGGGGGGGGGGGGG
GGGGGGGGGGGGGGGGGGGGGGGGGGGG
GGGGGGGGGGGGGGGGGGGGGGGGGGGG
GGGGGGGGGGGGGGGGGGGGGGGGGGGG
GGGGGGGGGGGGGGGGGGGGGGGGGGGG
GGGGGGGGGGGGGGGGGGGGGGGGGGGG
GGGGGGGGGGGGGGGGGGGGGGGGGGGG
GGGGGGGGGGGGGGGGGGGGGGGGGGGG
GGGGGGGGGGGGGGGGGGGGGGGGGGGG
GGGGGGGGGGGGGGGGGGGGGGGGGGGG
GGGGGGGGGGGGGGGGGGGGGGGGGGGG
GGGGGGGGGGGGGGGGGGGGGGGGGGGG
GGGGGGGGGGGGGGGGGGGGGGGGGGGG
GGGGGGGGGGGGGGGGGGGGGGGGGGGG
GGGGGGGGGGGGGGGGGGGGGGGGGGGG
GGGGGGGGGGGGGGGGGGGGGGGGGGGG
GGGGGGGGGGGGGGGGGGGGGGGGGGGG
GGGGGGGGGGGGGGGGGGGGGGGGGGGG
GGGGGGGGGGGGGGGGGGGGGGGGGGGG
GGGGGGGGGGGGGGGGGGGGGGGGGGGG
GGGGGGGGGGGGGGGGGGGGGGGGGGGG
GGGGGGGGGGGGGGGGGGGGGGGGGGGG
GGGGGGGGGGGGGGGGGGGGGGGGGGGG
GGGGGGGGGGGGGGGGGGGGGGGGGGGG
[ENTITY]
