75.map
[RSC]
G grassDead.png
M rockyMountain.png
# waterToxic.png
S waterToxicWithStone.png
% wall.png
[AT]
MMMMMMMMMMMMMMMMMMMMMMMMMMMM
MMMMMMMMMMMMMMMMMMMMMMMMMMMM
#####################......%
#####################......%
#####################......%
#####################......%
#####################......%
#####################......%
#####################......%
#####################......%
#####################.......
#####################.......
#####################......%
...........................%
#####################......%
#####################......%
#####################......%
#####################......%
#####################......%
#####################......%
....#################......%
.....################......%
......###############MMMMMM%
WWWWWWW##############MMMMMM%
[UNDER]
MMMMMMMMMMMMMMMMMMMMMMMMMMMM
MMMMMMMMMMMMMMMMMMMMMMMMMMMM
#####################GGGGGGG
#####################GGGGGGG
#####################GGGGGGG
#####################GGGGGGG
#####################GGGGGGG
#####################GGGGGGG
#####################GGGGGGG
#####################GGGGGGG
#####################GGGGGGG
#####################GGGGGGG
#####################GGGGGGG
SSSSSSSSSSSSSSSSSSSSSGGGGGGG
#####################GGGGGGG
#####################GGGGGGG
#####################GGGGGGG
#####################GGGGGGG
#####################GGGGGGG
#####################GGGGGGG
GGGG#################GGGGGGG
GGGGG################GGGGGGG
GGGGGG###############GGGGGGG
GGGGGGG##############GGGGGGG

[ENTITY]
