7_6.map
[RSC]
G grassDead.png
M rockyMountain.png
# water.png
s waterWithStone.png
X waterToxic.png
S waterToxicWithStone.png
W wall.png
R rubbleDead.png
[AT]
WWWWWWWXXXXXXXXXXXXXXMMMMMMM
.......XXXXXXXXXXXXXXMMMMMMM
.......XXXXX#XXXXXXXX.....MM
.......#XXXXX#XXXXX#X.....MM
.......##XXX###XXXX##.....MM
..........................MM
..........................MM
#####################.....MM
#####################.....MM
#####################.....MM
#####################.....MM
#####################.....MM
#####################.....MM
#####################.....MM
#####################.....MM
#####################.....MM
####MMMMMM###########.....MM
###MMMMMMMM##########.....MM
##MMMM###MMM#########.....MM
#MMMM#####MMM########.....MM
MMMM#################.....MM
MMMM#################.....MM
MMMM......................MM
MMMM......................MM
[UNDER]
GGGGGGGXXXXXXXXXXXXXXMMMMMMM
GGGGGGGXXXXXXXXXXXXXXMMMMMMM
GRGGGGGXXXXX#XXXXXXXXGGGGGGG
GGGGGGG#XXXXX#XXXXX#XGGGGGGG
GGGGRGG##XXX###XXXX##GGGGGGG
GGGGGGGsssSsssssSSSssGGGGGGG
GGGGGGGssssssssssSsssGGGGGGG
#####################GGGGGGG
#####################GGGGGGG
#####################GGGGGGG
#####################GGGGGGG
#####################GGGGGGG
#####################GGGGGGG
#####################GGGGGGG
#####################GGGGGGG
#####################GGGGGGG
#####################GGGGGGG
#####################GGGGGGG
#####################GGGGGGG
#####################GGGGGGG
MMMM#################GGGGGGG
MMMM#################GGGGGGG
MMMMGGGGGGGGGGGGGGGGGGGGGGGG
MMMMGGGGGGGGGGGGGGGGGGGGGGGG
[ENTITY]
