7_7.map
[RSC]
G grassDead.png
R rockyMountain.png
M mountain.png
# waterToxic.png
W wall.png
T treeDyingBottom.png
Q treeDyingTop.png
@ impassableRockDead.png
[AT]
RRRR......................RR
RRRR......................RR
RRRR.T................T...RR
RRRR.....................RRR
RRRR....T..............RRRRR
RRRR............R.....RRRRRR
RRRR...........RRR...RRRRRRR
RRRR...........RRRRRRRRRRRRR
RRRR...........RRRRRRR..RRRR
RRRR..............RRR...RRRR
RRRRR...................RRRR
RRRRRR..................RRRR
RRRRRRR.........R.......RRRR
RRRRRRRR.......RRRR....RRRRR
RRRRRRRRR....RRRRRR....RRRRR
RRRR..RRRR..RRRRR.....RRRRRR
RRRR...RRRRRRRRR.....RRRRRRR
RRRR....RRRRR.......RRRRRRRR
RRRR......RR.......RRRRRRRRR
RRRR.............RRRRRRRRRRR
RRRR..............RRRRRRRRRR
RMR...T...........RRRRRRRRRW
@MM..............MM@R@RRRRWW
@MM.............MM@@@@@@WWWW
[UNDER]
GGGGGGGGGGGGGGGGGGGGGGGGGGGG
GGGGGGGGGGGGGGGGGGGGGGGGGGGG
GGGGGGGGGGGGGGGGGGGGGGGGGGGG
GGGGGGGGGGGGGGGGGGGGGGGGGGGG
GGGGGGGGGGGGGGGGGGGGGGGGGGGG
GGGGGGGGGGGGGGGGGGGGGGGGGGGG
GGGGGGGGGGGGGGGGGGGGGGGGGGGG
GGGGGGGGGGGGGGGGGGGGGGGGGGGG
GGGGGGGGGGGGGGGGGGGGGGGGGGGG
GGGGGGGGGGGGGGGGGGGGGGGGGGGG
GGGGGGGGGGGGGGGGGGGGGGGGGGGG
GGGGGGGGGGGGGGGGGGGGGGGGGGGG
GGGGGGGGGGGGGGGGGGGGGGGGGGGG
GGGGGGGGGGGGGGGGGGGGGGGGGGGG
GGGGGGGGGGGGGGGGGGGGGGGGGGGG
GGGGGGGGGGGGGGGGGGGGGGGGGGGG
GGGGGGGGGGGGGGGGGGGGGGGGGGGG
GGGGGGGGGGGGGGGGGGGGGGGGGGGG
GGGGGGGGGGGGGGGGGGGGGGGGGGGG
GGGGGGGGGGGGGGGGGGGGGGGGGGGG
GGGGGGGGGGGGGGGGGGGGGGGGGGGG
GGGGGGGGGGGGGGGGGGGGGGGGGGGG
GGGGGGGGGGGGGGGGGGGGGGGGGGGG
GGGGGGGGGGGGGGGGGGGGGGGGGGGG
[OVER]
............................
.....Q................Q.....
............................
........Q...................
............................
............................
............................
............................
............................
............................
............................
............................
............................
............................
............................
............................
............................
............................
............................
............................
......Q.....................
............................
............................
............................
[ENTITY]



















