7_7.map
[RSC]
G grassDead.png
M rocks.png
# waterToxic.png
W wall.png
R rubbleDead.png
T treeDyingBottom.png
Q treeDyingTop.png
[AT]
MMMM.Q................Q...MM
MMMM.T................T...MM
MMMM......................MM
MMMM....Q................MMM
MMMM....T..............MMMMM
MMMM............M.....MMMMMM
MMMM...........MMM...MMMMMMM
MMMM...........MMMMMMMMMMMMM
MMMM...........MMMMMMM..MMMM
MMMM..............MMM...MMMM
MMMMM...................MMMM
MMMMMM..................MMMM
MMMMMMM.........M.......MMMM
MMMMMMMM.......MMMM....MMMMM
MMMMMMMMM....MMMMMM....MMMMM
MMMM..MMMM..MMMMM.....MMMMMM
MMMM...MMMMMMMMM.....MMMMMMM
MMMM....MMMMM.......MMMMMMMM
MMMM......MM.......MMMMMMMMM
MMMM.............MMMMMMMMMMM
MMMM..Q...........MMMMMMMMMM
MMM...T...........MMMMMMMMMM
MMM..............MMMMMMMMMMM
MMM.............MMMMMMMMMMMM
[UNDER]
GGGGGGGGGGGGGGGGGGGGGGGGGGGG
GGGGGGGGGGGGGGGGGGGGGGGGGGGG
GGGGGGGGGGGGGGGGGGGRGGGGGGGG
GGGGGGGGGGGGGGGGGGGGGGGGGGGG
GGGGGGGGGGGGGGGGGGGGGGGGGGGG
GGGGGGGGGGGGGGGGGGGGGGGGGGGG
GGGGGGGGGGGGGGGGGGGGGGGGGGGG
GGGGGGGGGGGGGGGGGGGGGGGGGGGG
GGGGGGGGGGGGGGGGGGGGGGGGGGGG
GGGGGGGGGGGGGGGGGGGGGGGGGGGG
GGGGGGGGGGGGGGGGGGGGGGGGGGGG
GGGGGGGGGGGGGGGGGGGGGGGGGGGG
GGGGGGGGGGGGGGGGGGGGGGGGGGGG
GGGGGGGGGGGGGGGGGGGGGGGGGGGG
GGGGGGGGGGGGGGGGGGGGGGGGGGGG
GGGGGGGGGGGGGGGGGGGGGGGGGGGG
GGGGGGGGGGGGGGGGGGGGGGGGGGGG
GGGGGGGGGGGGGGGGGGGGGGGGGGGG
GGGGGGGGGGGGGGGGGGGGGGGGGGGG
GGGGGGGGGGGGGGGGGGGGGGGGGGGG
GGGGGGGGGGGGGGGGGGGGGGGGGGGG
GGGGGGGGGGGGGGGGGGGGGGGGGGGG
GGGRGGGGGGGGGGGGGGGGGGGGGGGG
GGGGGGGGGGGGGGGGGGGGGGGGGGGG
[ENTITY]



















