Tile8_2
[RSC]
s sand.png
O water.png
M rockyMountain.png
t treeTop.png
b treeBottom.png
f dirt.png
G grass.png
[AT]
MMMMMMMMMMMMMMMMMMMMMMMMMMMM
....MMMMMMMMMMMM.....MMMMMMM
..........MMMMMM.....MMMMM..
.............MMMM...MMMM....
.......b....................
OO...........b..b...b.......
OOOOO....................b..
OOOOO..............b........
OOOOOO......................
OOOOOOOOO...................
OOOOOOOOOOOO................
OOOOOOOOOOOOOOO.............
OOOOOOOOOOOOOOO...OOOO......
OOOOOOOOOOOOOOO...OOOOOOOOOO
OOOOOOOOOOOOOOO...OOOOOOOOOO
OOOOOOOOOOOOOOO...OOOOOOOOOO
OOOOOOOOOOOOOOO...OOOOOOOOOO
OOOOOOOOOOOOOOO...OOOOOOOOOO
OOO.OOOOOOOOOOO...OOOOOOOOOO
OOOOOOOO............OOOOOOOO
...OOOO..............OOOOOOO
......................OOOOOO
OO.....................OOOOO
OOOOO..................OOOOO
[UNDER]
............................
GGGG............fffff.......
ssGGGGGGGG......fffff.....GG
sssGGGGGGGGGG....fff....GGGG
sssssGGGGGGGGGGGGGGGGGGGGGGG
..ssssssGGGGGGGGGGGGGGGGGGGG
.....ssssGGGGGGGGGGGGGGGGGGG
.....ssssGGGGGGGGGGGGGGGGGGG
......ssssssGGGGGGGGGGGGGGGG
.........ssssssssssGGGGGGGGG
............ssssssssssssssss
...............sssssssssssss
...............sss....ssssss
...............sss..........
...............sss..........
...............sss..........
...............sss..........
...............sss..........
...s...........sss..........
........ssssssssssss........
sss....ssssssssssssss.......
ssssssssssssssssssssss......
..sssssssssssssssssssss.....
.....ssssssssssssssssss.....
[OVER]
............................
............................
............................
.......t....................
.............t..t...t.......
.........................t..
...................t........
............................
............................
............................
............................
............................
............................
............................
............................
............................
............................
............................
............................
............................
............................
............................
............................
............................
[ENTITY]
skeleton skeletonDown.png 608 64
skeleton skeletonDown.png 640 64
skeleton skeletonDown.png 608 96
skeleton skeletonDown.png 608 256
