8-9
[RSC]
Y treeDyingTop.png
T treeDyingBottom.png
G grassDead.png
% impassableRockDead.png

[AT]
%%%%%%%%%%%%%%%%%%%%%%%%%%%%
...%%......%%......%%%%%%%%%
...%%......%%......%%%%%%%%%
%..%%..%%..%%..%%..%%.......
%..%%..%%..%%..%%..%%.......
%..%%..%%..%%..%%..%%..%%%%%
%..%%..%%..%%..%%..%%..%%%%%
%..%%..%%..%%..%%......%%%%%
%..%%..%%......%%......%%%%%
%..%%..%%......%%%%%%%%%%%%%
%......%%%%%%%%%%%%%%%%%%%%%
%......%%%%%%%%%%..........%
%%%%%%%%%..................%
%%%%%%%%%..........%%%%%%..%
%..........%%%%%%%%%%%%%%..%
%..........%%%%%%%%........%
%..%%%%%%%%%%..............%
...%%%%%%%%%%..............%
...%%%%................Y...%
%%%%%%%................T...%
%%%%%%%......Y.............%
.............T.............%
...........................%
%%%%%%%%%%%%%%%%%%%%%%%%%%%%

[UNDER]
GGGGGGGGGGGGGGGGGGGGGGGGGGGG
GGGGGGGGGGGGGGGGGGGGGGGGGGGG
GGGGGGGGGGGGGGGGGGGGGGGGGGGG
GGGGGGGGGGGGGGGGGGGGGGGGGGGG
GGGGGGGGGGGGGGGGGGGGGGGGGGGG
GGGGGGGGGGGGGGGGGGGGGGGGGGGG
GGGGGGGGGGGGGGGGGGGGGGGGGGGG
GGGGGGGGGGGGGGGGGGGGGGGGGGGG
GGGGGGGGGGGGGGGGGGGGGGGGGGGG
GGGGGGGGGGGGGGGGGGGGGGGGGGGG
GGGGGGGGGGGGGGGGGGGGGGGGGGGG
GGGGGGGGGGGGGGGGGGGGGGGGGGGG
GGGGGGGGGGGGGGGGGGGGGGGGGGGG
GGGGGGGGGGGGGGGGGGGGGGGGGGGG
GGGGGGGGGGGGGGGGGGGGGGGGGGGG
GGGGGGGGGGGGGGGGGGGGGGGGGGGG
GGGGGGGGGGGGGGGGGGGGGGGGGGGG
GGGGGGGGGGGGGGGGGGGGGGGGGGGG
GGGGGGGGGGGGGGGGGGGGGGGGGGGG
GGGGGGGGGGGGGGGGGGGGGGGGGGGG
GGGGGGGGGGGGGGGGGGGGGGGGGGGG
GGGGGGGGGGGGGGGGGGGGGGGGGGGG
GGGGGGGGGGGGGGGGGGGGGGGGGGGG
GGGGGGGGGGGGGGGGGGGGGGGGGGGG

[ENTITY]
