8-9
[RSC]
Y treeDyingTop.png
T treeDyingBottom.png
G grassDead.png
M mountain.png

[AT]
MMMMMMMMMMMMMMMMMMMMMMMMMMMM
...MM......MM......MMMMMMMMM
...MM......MM......MMMMMMMMM
M..MM..MM..MM..MM..MM.......
M..MM..MM..MM..MM..MM.......
M..MM..MM..MM..MM..MM..MMMMM
M..MM..MM..MM..MM..MM..MMMMM
M..MM..MM..MM..MM......MMMMM
M..MM..MM......MM......MMMMM
M..MM..MM......MMMMMMMMMMMMM
M......MMMMMMMMMMMMMMMMMMMMM
M......MMMMMMMMMM..........M
MMMMMMMMM..................M
MMMMMMMMM..........MMMMMM..M
M..........MMMMMMMMMMMMMM..M
M..........MMMMMMMM........M
M..MMMMMMMMMM..............M
...MMMMMMMMMM..............M
...MMMM....................M
MMMMMMM................T...M
MMMMMMM....................M
.............T.............M
...........................M
MMMMMMMMMMMMMMMMMMMMMMMMMMMM

[UNDER]
GGGGGGGGGGGGGGGGGGGGGGGGGGGG
GGGGGGGGGGGGGGGGGGGGGGGGGGGG
GGGGGGGGGGGGGGGGGGGGGGGGGGGG
GGGGGGGGGGGGGGGGGGGGGGGGGGGG
GGGGGGGGGGGGGGGGGGGGGGGGGGGG
GGGGGGGGGGGGGGGGGGGGGGGGGGGG
GGGGGGGGGGGGGGGGGGGGGGGGGGGG
GGGGGGGGGGGGGGGGGGGGGGGGGGGG
GGGGGGGGGGGGGGGGGGGGGGGGGGGG
GGGGGGGGGGGGGGGGGGGGGGGGGGGG
GGGGGGGGGGGGGGGGGGGGGGGGGGGG
GGGGGGGGGGGGGGGGGGGGGGGGGGGG
GGGGGGGGGGGGGGGGGGGGGGGGGGGG
GGGGGGGGGGGGGGGGGGGGGGGGGGGG
GGGGGGGGGGGGGGGGGGGGGGGGGGGG
GGGGGGGGGGGGGGGGGGGGGGGGGGGG
GGGGGGGGGGGGGGGGGGGGGGGGGGGG
GGGGGGGGGGGGGGGGGGGGGGGGGGGG
GGGGGGGGGGGGGGGGGGGGGGGGGGGG
GGGGGGGGGGGGGGGGGGGGGGGGGGGG
GGGGGGGGGGGGGGGGGGGGGGGGGGGG
GGGGGGGGGGGGGGGGGGGGGGGGGGGG
GGGGGGGGGGGGGGGGGGGGGGGGGGGG
GGGGGGGGGGGGGGGGGGGGGGGGGGGG

[OVER]
............................
............................
............................
............................
............................
............................
............................
............................
............................
............................
............................
............................
............................
............................
............................
............................
............................
............................
.......................Y....
............................
.............Y..............
............................
............................
............................

[ENTITY]
