The (9,1) position in the map grid
[RSC]
O water.png
S sand.png
B waterWithStone.png
G grass.png
M rockyMountain.png
t treeTop.png
b treeBottom.png
[AT]
OO..OOOOOOOOOOOOOOOOOOOOOOOO
OO..OOOOOOOOOOOOOOOOOOOOOOOO
...........OOOOOOOOOOOOOOOOO
.............OOOOOOOOOOOOOOO
..............OOOOOOOOOOOOOO
...t...........OOOOOOOOOOOOO
...b...t.......OOOOOOOOOOOOO
.......b...t....OOOOOOOOOOOO
...........b.....OOOOOOOOOOO
.................OOOOOOOOOOO
MMMMMMMMMM.......OOOOOOOOOOO
MMMMMMMMMM.......OOOOOOOOOOO
MMMMMMMMMM....t..OOOOOOOOOOO
MMMMMMMMMM....b..OOOOOOOOOOO
MMMMMMMMMM.......OOOOOOOOOOO
MMMMMMMMMM.......OOOOOOOOOOO
MMMMMMMMMM.......OOOOOOOOOOO
MMMMMMMMMMM.......OOOOOOOOOO
MMMMMMMMMMMM.......OOOOOOOOO
MMMMMMMMMMMMM.......OOOOOOOO
MMMMMMMMMMMMM....t..OOOOOOOO
MMMMMMMMMMMMMM...b...OOOOOOO
MMMMMMMMMMMMMM.......OOOOOOO
MMMMMMMMMMMMMM.......OOOOOOO
[UNDER]
..BB........................
..BB........................
SSSSSSSSSSS.................
SSSSSSSSSSSSS...............
SSSSSSSSSSSSSS..............
GGG.GGGGGGGSSSS.............
GGG.GGG.GGGGSSS.............
GGGGGGG.GGG.GSSS............
GGGGGGGGGGG.GGSSS...........
GGGGGGGGGGGGGGSSS...........
..........GGGGSSS...........
..........GGGGSSS...........
..........GGGG.SS...........
..........GGGG.SS...........
..........GGGGSSS...........
..........GGGGSSS...........
..........GGGGSSS...........
............GGGSSS..........
............GGGGSSS.........
.............GGGGSSS........
.............GGGG.SS........
..............GGG.SSS.......
..............GGGGSSS.......
..............GGGGSSS.......
[ENTITY]
skeleton skeletonDown.png 256 256