Tile9_2
[RSC]
s sand.png
O water.png
M rockyMountain.png
f dirt.png
G grass.png
t treeTop.png
b treeBottom.png
[AT]
MMMMMMMMMMMMMM.....OOOOOOOOO
MMMMMMMMMMMMM......OOOOOOOOO
........MMMM.......OOOOOOOOO
...................OOOOOOOOO
.....b.............OOOOOOOOO
...................OOOOOOOOO
........b..........OOOOOOOOO
...................OOOOOOOOO
...b...............OOOOOOOOO
...................OOOOOOOOO
...................OOOOOOOOO
...............OOOOOOOOOOOOO
...........OOOOOOOOOOOOOOOOO
OOOOOOOOOOOOOOOOOOOOOOOOOOOO
OOOOOOOOOOOOOOOOOOOOOOOOOOOO
OOOOOOOOOOOOOOOOOOOOOOOOOOOO
OOOOOOOOOOOOOOOOOOOOOOOOOOOO
OOOOOOOOOOOOOOOOOOOOOOOOOOOO
OOOOOOOOOOOOOOOOOOOOOOOOOOOO
OOOOOOOOOOOOOOOOOOOOOOO...OO
OOOOOOOOOOOOOOOOOOOOOO....OO
OOOOOOOOOOOOOOOOOOOOO......O
OOOOOOOOOOOOOOOOOOOOO......M
OOOOOOOOOOOOOOOOOOOOO......M
[UNDER]
....GGGGGGGGsssssss.........
...GGGGGG.GGsssssss.........
GGGGGGGGG.GGGssssss.........
GGGGGGGGGGGGGssssss.........
GGGGGGGGGGGGGssssss.........
GGGGGGGGGGGGGssssss.........
GGGGGGGGGGGGsssssss.........
GGGGGGGGGGGssssssss.........
GGGGGGGGGssssssssss.........
GGGGGGsssssssssssss.........
sssssssssssssssssss.........
sssssssssssssss.............
sssssssssss.................
............................
............................
............................
............................
.........................sss
........................ssss
.......................sssss
......................ssssss
.....................sssssss
.....................sssssss
....................ssssssss
[OVER]
............................
............................
............................
.....t......................
............................
........t...................
............................
...t........................
............................
............................
............................
............................
............................
............................
............................
............................
............................
............................
............................
............................
............................
............................
............................
............................
[ENTITY]
