Tile8_3
[RSC]
G grass.png
M rockyMountain.png
s sand.png
O water.png
[AT]
OOOOOOOOOOOOOOOOOOOOO......M
OOOOOOOOOOOOOOOOOOOO.......M
OOOOOOOOOOOOOOOOOOO........M
OOOOOOOOOOOOOOOOO..........M
OOOOOOOOOOOOOOOO...........M
OOOOOOOOOOOOOOOO...........M
OOOOOOOOOOOOOOO............M
OOOOOOOOOOOOOO.............M
OOOOOOOOOOOOO..............M
OOOOOOOOOOO................M
OOOOOOOOOO.................M
OOOOOOOOO..................M
OOOOOOOOO..................M
OOOOOOOO...................M
OOOOOOOO...................M
OOOOOOOO...................M
OOOOOOO....................M
OOOOOOO....................M
OOOOO......................M
OOO........................M
O..........................M
...........................M
...........................M
...........................M
[UNDER]
.....................ssGGGGG
....................ssGGGGGG
...................ssGGGGGGG
.................ssGGGGGGGGG
................ssGGGGGGGGGG
................ssGGGGGGGGGG
...............ssGGGGGGGGGGG
..............ssGGGGGGGGGGGG
.............ssGGGGGGGGGGGGG
...........ssGGGGGGGGGGGGGGG
..........ssGGGGGGGGGGGGGGGG
.........ssGGGGGGGGGGGGGGGGG
.........ssGGGGGGGGGGGGGGGGG
........ssGGGGGGGGGGGGGGGGGG
........ssGGGGGGGGGGGGGGGGGG
........ssGGGGGGGGGGGGGGGGGG
.......ssGGGGGGGGGGGGGGGGGGG
.......ssGGGGGGGGGGGGGGGGGGG
.....ssGGGGGGGGGGGGGGGGGGGGG
...ssGGGGGGGGGGGGGGGGGGGGGGG
.sssGGGGGGGGGGGGGGGGGGGGGGGG
sssGGGGGGGGGGGGGGGGGGGGGGGGG
ssGGGGGGGGGGGGGGGGGGGGGGGGGG
sGGGGGGGGGGGGGGGGGGGGGGGGGGG
[ENTITY]



