0_1.map
[RSC]
G ground.png
M mountain.png
D dirt.png

[AT]
MMM.........................
MMM.........................
MMM.........................
MMM.........................
MMM.........................
MMM.........................
MMM....DDDDD................
MMM....DDDDD................
MMM....DDDDD................
MMM....DDDDD................
MMM.........................
MMM.........................
MMM.........................
MMM....DDDDD................
MMM....DDDDD................
MMM....DDDDD................
MMM....DDDDD................
MMM.........................
MMM.........................
MMM.........................
MMM.........................
MMM.........................
MMM.........................
MMM.........................

[UNDER]
...GGGGGGGGGGGGGGGGGGGGGGGGG
...GGGGGGGGGGGGGGGGGGGGGGGGG
...GGGGGGGGGGGGGGGGGGGGGGGGG
...GGGGGGGGGGGGGGGGGGGGGGGGG
...GGGGGGGGGGGGGGGGGGGGGGGGG
...GGGGGGGGGGGGGGGGGGGGGGGGG
...GGGG.....GGGGGGGGGGGGGGGG
...GGGG.....GGGGGGGGGGGGGGGG
...GGGG.....GGGGGGGGGGGGGGGG
...GGGG.....GGGGGGGGGGGGGGGG
...GGGGGGGGGGGGGGGGGGGGGGGGG
...GGGGGGGGGGGGGGGGGGGGGGGGG
...GGGGGGGGGGGGGGGGGGGGGGGGG
...GGGG.....GGGGGGGGGGGGGGGG
...GGGG.....GGGGGGGGGGGGGGGG
...GGGG.....GGGGGGGGGGGGGGGG
...GGGG.....GGGGGGGGGGGGGGGG
...GGGGGGGGGGGGGGGGGGGGGGGGG
...GGGGGGGGGGGGGGGGGGGGGGGGG
...GGGGGGGGGGGGGGGGGGGGGGGGG
...GGGGGGGGGGGGGGGGGGGGGGGGG
...GGGGGGGGGGGGGGGGGGGGGGGGG
...GGGGGGGGGGGGGGGGGGGGGGGGG
...GGGGGGGGGGGGGGGGGGGGGGGGG

[ENTITY]
skeleton skeleton.png 0,0
