1_0.map
[RSC]
G ground.png
D dirt.png
M mountain.png

[AT]
MMMMMMMMMMMMMMMMMMMMMMMMMMMM
MMMMMMMMMMMMMMMMMMMMMMMMMMMM
MMMMMMMMMMMMMMMMMMMMMMMMMMMM
............................
............................
............................
............................
............................
............................
............................
.................DDDDDD.....
.................DDDDDD.....
.................DDDDDD.....
.................DDDDDD.....
.................DDDDDD.....
.................DDDDDD.....
............................
............................
............................
............................
............................
............................
............................
............................

[UNDER]
............................
............................
............................
GGGGGGGGGGGGGGGGGGGGGGGGGGGG
GGGGGGGGGGGGGGGGGGGGGGGGGGGG
GGGGGGGGGGGGGGGGGGGGGGGGGGGG
GGGGGGGGGGGGGGGGGGGGGGGGGGGG
GGGGGGGGGGGGGGGGGGGGGGGGGGGG
GGGGGGGGGGGGGGGGGGGGGGGGGGGG
GGGGGGGGGGGGGGGGGGGGGGGGGGGG
DDDDDDDDDDDDDDDGG......GGGGG
DDDDDDDDDDDDDDDGG......GGGGG
DDDDDDDDDDDDDDDDD......GGGGG
GGGGGGGGGGGGDDDDD......GGGGG
GGGGGGGGGGGGDDDGG......GGGGG
GGGGGGGGGGGGDDDGG......GGGGG
GGGGGGGGGGGGDDDGGGGGGGGGGGGG
GGGGGGGGGGGGDDDGGGGGGGGGGGGG
GGGGGGGGGGGGDDDGGGGGGGGGGGGG
GGGGGGGGGGGGDDDGGGGGGGGGGGGG
GGGGGGGGGGGGDDDGGGGGGGGGGGGG
GGGGGGGGGGGGDDDGGGGGGGGGGGGG
GGGGGGGGGGGGDDDGGGGGGGGGGGGG
GGGGGGGGGGGGDDDGGGGGGGGGGGGG
