Tile4_2
[RSC]
G grass.png
M rockyMountain.png
s sand.png
O water.png
[AT]
....................OOOOOOOO
.....................OOOOOOO
......................OOOOOO
......................OOOOOO
.......................OOOOO
.........................OOO
...........................O
............................
............................
............................
............................
............................
............................
............................
............................
............................
............................
............................
............................
............................
............................
............................
............................
............................
[UNDER]
GGGGGGGGGGGGssssssss........
GGGGGGGGGGGGGssssssss.......
GGGGGGGGGGGGGGGsssssss......
GGGGGGGGGGGGGGGGGsssss......
GGGGGGGGGGGGGGGGGGGssss.....
GGGGGGGGGGGGGGGGGGGGGssss...
GGGGGGGGGGGGGGGGGGGGGGGGsss.
GGGGGGGGGGGGGGGGGGGGGGGGGsss
GGGGGGGGGGGGGGGGGGGGGGGGGGGs
GGGGGGGGGGGGGGGGGGGGGGGGGGGG
GGGGGGGGGGGGGGGGGGGGGGGGGGGG
GGGGGGGGGGGGGGGGGGGGGGGGGGGG
GGGGGGGGGGGGGGGGGGGGGGGGGGGG
GGGGGGGGGGGGGGGGGGGGGGGGGGGG
GGGGGGGGGGGGGGGGGGGGGGGGGGGG
GGGGGGGGGGGGGGGGGGGGGGGGGGGG
GGGGGGGGGGGGGGGGGGGGGGGGGGGG
GGGGGGGGGGGGGGGGGGGGGGGGGGGG
GGGGGGGGGGGGGGGGGGGGGGGGGGGG
GGGGGGGGGGGGGGGGGGGGGGGGGGGG
GGGGGGGGGGGGGGGGGGGGGGGGGGGG
GGGGGGGGGGGGGGGGGGGGGGGGGGGG
GGGGGGGGGGGGGGGGGGGGGGGGGGGG
GGGGGGGGGGGGGGGGGGGGGGGGGGGG
[ENTITY]