5_8.map
[RSC]
G grassDead.png
M mountain.png
# waterToxic.png
W wall.png
R rubbleDead.png
T treeDyingBottom.png
Q treeDyingTop.png
[AT]
MMWWWWWWWWWWWWWWWWWWQWQWWWWW
MM..................QWQ.....
MM..WWWWWWWWWWWWWW..QWQ....M
MM..W............W..TWT....M
MM...............W..WWW....M
MM.....WWWWWWWW..WWWWWW....M
MM..Q.QW.Q.Q.Q...W..QWQ....M
MM..Q.QW.T.T.T...W..QWQ....M
MM..T.QW............TWT....M
......QW...WWWWWWWWWWWW....M
......QW...WW..............M
......QW...WW..............M
......QW...WW..............M
MM..W.QW...WW..............M
MM....QW...WWWWWWWWWWWWWWWWM
MM..Q.QW....................
MM..Q.TW....................
MM..T..WWWWWWWWWWWWWWWWWWWWW
MM..........................
MM.###.Q.Q.Q.Q.Q.Q.Q...MMM..
MM.###.T.T.T.T.T.T.T...MMM..
MM.#################...MMM..
MM.#################...MMM..
MM..........................
[UNDER]
MMGGGGGGGGGGGGGGGGGGWWWWGGGG
MMGGGGGGGGGGGGGGGGGGTWTGGGGG
MMGGGGGGGGGGGGGGGGGGTGTGGGGG
MMGGGGGGGGGGGGGGGGGGTGTGGGGG
MMGGGGGGGGGGGGGGGGGGTGTGGGGG
MMGGGGGWGGGGGGGGGGGGTGTGGGGG
MMGGTGTGGGGGGGGGGGGGTGTGGGGG
MMGGTGTGGGGGGGGGGGGGGGGGGGGG
MMGGGGTGGGGGGGGGGGGGGGGGGGGG
MMGGGGTGGGGGGGGGGGGGGGGGGGGG
GRGGGGTGGGGGGGGGGGGGGGGGGGGG
GGGGGGTGGGGGGGGGGGGGGGGGGGGG
GGGGGGTGGGGGGGGGGGGGGGGGGGGG
GRGGGGTGGGGGGGGGGGGGGGGGGGGG
MMGGTGTGGGGGGGGGGGGGGGGGGGGG
MMGGTGTGGGGGGGGGGGGGGGGGGGGG
MMGGGGGGGGGGGGGGGGGGGGGGGGGG
MMGGRGGGGGGGGGGGGGGGGGGGGGGG
MMGGGGGGGGGGGGGGGGGGGGGGGGGG
MMGGGGGGGGGGGGGGGGGGGGGGGGGG
MMGGGGGGGGGGGGGGGGGRGGGGGGGG
MMGGGGGGGGGGGGGGGGGGGGGGGGGG
MMGGGGGGGGGGGGGGGGGGGGGGGGGG
MMGGGGGGGGGGGGGGGGGGGGGGGGGG
[ENTITY]
Skel skeletonDown.png 512 352
Skel2 skeletonDown.png 576 352



















