The (6,0) position in the map grid
[RSC]
O water.png
S sand.png
B waterWithStone.png
[AT]
OOOOOOOOOOOOOOOOOOOOOOOOOOOO
OOOOOOOOOOOOOOOOOOOOOOOOOOOO
OOOOOOOOOOOOOOOOOOOOOOOOOOOO
OOOOOOOOOOOOOOOOOOOOOOOOOOOO
OOOOOOOOOOOOOOOOOOOOOOOOOOOO
OOOOOOOOOOOOO.OOOOOOOOOOOOOO
OOOOOOOOOOOO...OOOOOOOOOOOOO
OOOOOOOOOO.......OOOOOOOOOOO
OOOOOOOO...........OOOOOOOOO
OOOOOO...............OOOOOOO
OOOO...................OOOOO
OOO.....................OOOO
OO......................OOOO
O........................OOO
............................
............................
.........................OOO
.........................OOO
.........................OOO
.........................OOO
.........................OOO
.........................OOO
..........................OO
..........................OO
[UNDER]
............................
............................
............................
............................
............................
.............S..............
............SSS.............
..........SSSSSSS...........
........SSSSSSSSSSS.........
......SSSSSSSSSSSSSSS.......
....SSSSSSSSSSSSSSSSSSS.....
...SSSSSSSSSSSSSSSSSSSSS....
..SSSSSSSSSSSSSSSSSSSSSS....
.SSSSSSSSSSSSSSSSSSSSSSSS...
SSSSSSSSSSSSSSSSSSSSSSSSSBBB
SSSSSSSSSSSSSSSSSSSSSSSSSBBB
SSSSSSSSSSSSSSSSSSSSSSSSS...
SSSSSSSSSSSSSSSSSSSSSSSSS...
SSSSSSSSSSSSSSSSSSSSSSSSS...
SSSSSSSSSSSSSSSSSSSSSSSSS...
SSSSSSSSSSSSSSSSSSSSSSSSS...
SSSSSSSSSSSSSSSSSSSSSSSSS...
SSSSSSSSSSSSSSSSSSSSSSSSSS..
SSSSSSSSSSSSSSSSSSSSSSSSSS..
[ENTITY]
skeleton skeletonDown.png 384 384