6_7.map
[RSC]
G grassDead.png
M rocks.png
# waterToxic.png
W wall.png
R rubbleDead.png
T treeDyingBottom.png
Q treeDyingTop.png
H barHedgeDead.png
[AT]
MMMMMMMMMMMMMMMMMMMMM...MMMM
MMMMMMMMMMMMMMMMMMMMM...MMMM
MMM...Q..QQQ..Q.......QQMMMM
Q...QQT..TTT..T.QQQQQQTTMMMM
T...TT..........TTTTTT..MMMM
QQ.QQ.Q.........W...WW..MMMM
TT.TT.T.QQ..............MMMM
........TT.QQQQQQWWWWWWWMMMM
...QQQQQQQQTTTTTT.......MMMM
...TTTTTTTT.............MMMM
WWWWWWWWW.........QQQ...MMMM
...........QQQQQQQTTT...MMMM
........QQQTTTTTTT......MMMM
....MMMMTTTQQQ..........MMMM
QHHMMMMMMQQTTT......MMMMMMMM
T####MMMMTTQ.....MMMMMMMMMMM
Q#####MMMMQT.....MMM.Q..MMMM
TT###MMQQQT...MMMMM..T..MMMM
QQM##MMTTT...MMMMM.....MMMMM
TTMMMMMMMM...MMMM....MMMMMMM
MMMM..MMMM....MMM...MM..MMMM
MMM......MM...MMM...MM..MMMM
MMM...Q...MM...MM...MM..MMMM
MMMM..T...MM...MM...MM..MMMM
[UNDER]
GGGGGGGGGGGGGGGGGGGGGGGGGGGG
GGGGGGGGGGGGGGGGGGGGGGGGGGGG
GGGGGGGGGGGGGGGGGGGRGGGGGGGG
GGGGGGGGGGGGGGGGGGGGGGGGGGGG
GGGGGGGGGGGGGGGGGGGGGGGGGGGG
GGGGGGGGGGGGGGGGGGGGGGGGGGGG
GGGGGGGGGGGGGGGGGGGGGGGGGGGG
GGGGGGGGGGGGGGGGGGGGGGGGGGGG
GGGGGGGGGGGGGGGGGGGGGGGGGGGG
GGGGGGGGGGGGGGGGGGGGGGGGGGGG
GGGGGGGGGGGGGGGGGGGGGGGGGGGG
GGGGGGGGGGGGGGGGGGGGGGGGGGGG
GGGGGGGGGGGGGGGGGGGGGGGGGGGG
GGGGGGGGGGGGGGGGGGGGGGGGGGGG
GGGGGGGGGGGGGGGGGGGGGGGGGGGG
GGGGGGGGGGGGGGGGGGGGGGGGGGGG
GGGGGGGGGGGGGGGGGGGGGGGGGGGG
GGGGGGGGGGGGGGGGGGGGGGGGGGGG
GGGGGGGGGGGGGGGGGGGGGGGGGGGG
GGGGGGGGGGGGGGGGGGGGGGGGGGGG
GGGGGGGGGGGGGGGGGGGGGGGGGGGG
GGGGGGGGGGGGGGGGGGGGGGGGGGGG
GGGRGGGGGGGGGGGGGGGGGGGGGGGG
GGGGGGGGGGGGGGGGGGGGGGGGGGGG
[ENTITY]
Skel skeletonDown.png 320 320


















