6_8.map
[RSC]
G grassDead.png
M rocks.png
# waterToxic.png
W wall.png
R rubbleDead.png
T treeDyingBottom.png
Q treeDyingTop.png
[AT]
MMMM..Q...MM...QQ...QQ..MMMM
......T...MM...TT...TT..MMMM
MMMM..Q...MM...QQ...QQ..MMMM
MMMMQQQ...QQ...TT...TT..MMMM
MMMMTTT...TT...QQ...QQ..MMMM
MMMMQQ....QQ...TT...TT..MMMM
MMMMTT....TT...QQQ......MMMM
MMMMMQ...QQQQ..TTT......MMMM
MMMMMT..QTTTTQ...QQQ...QMMMM
MMMMMM..TQQQ.T...TTT...TMMMM
MMMMMM...TTT...........QMMMM
MMMMMM.................TMMMM
MMMMMM..Q.Q..MMMMMMMM..QMMMM
MMMMMMMMT.T...MMMMMM...TMMMM
MMMMMMMMM.MM...MMMM....QMMMM
.....MMMM.MMM..........TMMMM
.QQ...MMM.MMMM..........MMMM
WTT..MMMM.MMMMMM########MMMM
..Q..MM.....MMMMMM####MMMMMM
..T..MMQ.....MMMMMMM##MMMMMM
.....MMT.....QQ..MMMMMMMMMMM
....MMMMQ....TT....MMMMMMMMM
..MMMMMMT............MMMMMMM
.MMMMMMMMM..............MMMM
[UNDER]
MMGGGGGGGGGGGGGGGGGGGGGGGGGG
GGGGGGGGGGGGGGGGGGGGGGGGGGGG
MMGGGGGGGGGGGGGGGGGRGGGGGGGG
MMGGGGGGGGGGGGGGGGGGGGGGGGGG
MMGGGGGGGGGGGGGGGGGGGGGGGGGG
MMGGGGGGGGGGGGGGGGGGGGGGGGGG
MMGGGGGGGGGGGGGGGGGGGGGGGGGG
MMGGGGGGGGGGGGGGGGGGGGGGGGGG
MMGGGGGGGGGGGGGGGGGGGGGGGGGG
MMGGGGGGGGGGGGGGGGGGGGGGGGGG
MMGGGGGGGGGGGGGGGGGGGGGGGGGG
MMGGGGGGGGGGGGGGGGGGGGGGGGGG
GGGGGGGGGGGGGGGGGGGGGGGGGGGG
GGGGGGGGGGGGGGGGGGGGGGGGGGGG
MMGGGGGGGGGGGGGGGGGGGGGGGGGG
MMGGGGGGGGGGGGGGGGGGGGGGGGGG
MMGGGGGGGGGGGGGGGGGGGGGGGGGG
MMGGGGGGGGGGGGGGGGGGGGGGGGGG
MMGGGGGGGGGGGGGGGGGGGGGGGGGG
GGGGGGGGGGGGGGGGGGGGGGGGGGGG
GGGGGGGGGGGRGGGGGGGGGGGGGGGG
GGGGGGGGGGGGGGGGGGGGGGGGGGGG
MMGRGGGGGGGGGGGGGGGGGGGGGGGG
MMGGGGGGGGGGGGGGGGGGGGGGGGGG
[ENTITY]
Skel skeletonDown.png 416 32
Skel skeletonDown.png 576 32
Skel skeletonDown.png 704 32


















