The (7,0) position in the map grid
[RSC]
O water.png
S sand.png
B waterWithStone.png
[AT]
OOOOOOOOOOOOOOOOOOOOOOOOOOOO
OOOOOOOOOOOOOOOOOOOOOOOOOOOO
OOOOOOOOOOOOOOOOOOOOOO......
OOOOOOOOOOOOOOOOOOO.........
OOOOOOOOOOOOOOOO............
OOOOOOOOOOOOOOOO............
OOOOOOOOOOOOOOO.............
OOOOOOOOOOOOOOO.............
OOOOOOOOOOOOOOO.............
OOOOOOOOOOOOOO..............
OOOOOOOOOOOOOO..............
OOOOOOOOOOOOO...............
OOOOOOOOOOOOO...............
OOOOOOOO....................
............................
..........OOO...............
OOOOOOOOOOOOOO..............
OOOOOOOOOOOOO...............
OOOOOOOOOOOOOO..............
OOOOOOOOOOOOOOOO............
OOOOOOOOOOOOOOOOOO..........
OOOOOOOOOOOOOOOOOOOO........
OOOOOOOOOOOOOOOOOOOOOOOOOOOO
OOOOOOOOOOOOOOOOOOOOOOOOOOOO
[UNDER]
............................
............................
......................SSSSSS
...................SSSSSSSSS
................SSSSSSSSSSSS
................SSSSSSSSSSSS
...............SSSSSSSSSSSSS
...............SSSSSSSSSSSSS
...............SSSSSSSSSSSSS
..............SSSSSSSSSSSSSS
..............SSSSSSSSSSSSSS
.............SSSSSSSSSSSSSSS
.............SSSSSSSSSSSSSSS
........BBBBBSSSSSSSSSSSSSSS
BBBBBBBBBBBBBSSSSSSSSSSSSSSS
BBBBBBBBBB...SSSSSSSSSSSSSSS
.............SSSSSSSSSSSSSSS
.............SSSSSSSSSSSSSSS
..............SSSSSSSSSSSSSS
................SSSSSSSSSSSS
..................SSSSSSSSSS
....................SSSSSSSS
............................
............................
[ENTITY]
skeleton skeletonDown.png 384 576