Tile7_4
[RSC]
W wall.png
M rockyMountain.png
G grass.png
[AT]
................MMMMMMMM....
................MMMMMMMM....
.................MMMMMMM....
..................MMMMMM....
...................MMMMMM...
....................MMMMMMMM
......................MMMMMM
..........................MM
............................
............................
............................
............................
MMMMMMMMMMMMMMMM............
MMMMMMMMMMMMMMMM............
MMMMMMMMMMMMMMMM............
MMMMMMMMMMMMMMMMM...........
MMMMMMMMMMMMMMMMM...........
MMMMMMMMMMMMMMMMM...........
MMMMMMMMMMMMMMMMMMM.........
MMMMMMMMMMMMMMMMMMMM........
MMMMMMMMMMMMMMMMMMMM........
MMMMMMMMMMMMMMMMMMMM........
MMMMMMMMMMMMMMMMMMMMMMMMMMMM
MMMMMMMMMMMMMMMMMMMMMMMMMMMM
[UNDER]
GGGGGGGGGGGGGGGG........GGGG
GGGGGGGGGGGGGGGG........GGGG
GGGGGGGGGGGGGGGGG.......GGGG
GGGGGGGGGGGGGGGGGG......GGGG
GGGGGGGGGGGGGGGGGGG......GGG
GGGGGGGGGGGGGGGGGGGG........
GGGGGGGGGGGGGGGGGGGGGG......
GGGGGGGGGGGGGGGGGGGGGGGGGG..
GGGGGGGGGGGGGGGGGGGGGGGGGGGG
GGGGGGGGGGGGGGGGGGGGGGGGGGGG
GGGGGGGGGGGGGGGGGGGGGGGGGGGG
GGGGGGGGGGGGGGGGGGGGGGGGGGGG
................GGGGGGGGGGGG
................GGGGGGGGGGGG
................GGGGGGGGGGGG
.................GGGGGGGGGGG
.................GGGGGGGGGGG
.................GGGGGGGGGGG
...................GGGGGGGGG
....................GGGGGGGG
....................GGGGGGGG
....................GGGGGGGG
............................
............................
[ENTITY]