The (8,0) position in the map grid
[RSC]
O water.png
S sand.png
B waterWithStone.png
[AT]
OOOOOOOOOOOOOOOOOOOOOOOOOOOO
OOOOOOOOOOOOOOOOOOOOOOOOOOOO
.....OOOOOOOOOOOOOOOOOOOOOOO
.......OOOOOOOOOOOOOOOOOOOOO
..........OOOOOOOOOOOOOOOOOO
..........OOOOOOOOOOOOOOOOOO
..........OOOOOOOOOOOOOOOOOO
..........OOOOOOOOOOOOOOOOOO
..........OOOOOOOOOOOOOOOOOO
..........OOOOOOOOOOOOOOOO..
..........OOOOOOOOOOOOOOO...
..........OOOOOOOOOOOOO.....
..........OOOOOOOOOOO.......
.............OOOOOOO........
..................O.........
..........OO................
..........OOOOOOO...........
..........OOOOOOOOO.........
..........OOOOOOOOO.........
..........OOOOOOOOO.........
........OOOOOOOOOOO.........
......OOOOOOOOOOOOOO........
OOOOOOOOOOOOOOOOOOOOOOOOOOOO
OOOOOOOOOOOOOOOOOOOOOOOOOOOO
[UNDER]
............................
............................
SSSSS.......................
SSSSSSS.....................
SSSSSSSSSS..................
SSSSSSSSSS..................
SSSSSSSSSS..................
SSSSSSSSSS..................
SSSSSSSSSS..................
SSSSSSSSSS................SS
SSSSSSSSSS...............SSS
SSSSSSSSSS.............SSSSS
SSSSSSSSSS...........SSSSSSS
SSSSSSSSSSBBB.......SSSSSSSS
SSSSSSSSSSBBBBBBBB.SSSSSSSSS
SSSSSSSSSS..BBBBBBBSSSSSSSSS
SSSSSSSSSS.......BBSSSSSSSSS
SSSSSSSSSS.........SSSSSSSSS
SSSSSSSSSS.........SSSSSSSSS
SSSSSSSSSS.........SSSSSSSSS
SSSSSSSS...........SSSSSSSSS
SSSSSS..............SSSSSSSS
............................
............................
[ENTITY]