The (8,1) position in the map grid
[RSC]
O water.png
S sand.png
B waterWithStone.png
G grass.png
M rockyMountain.png
t treeTop.png
b treeBottom.png
[AT]
OOOOOOOOOOOOOOOOOOOOOOOOOOOO
.............OOOOOOOOOOOOOOO
............................
............................
............................
.........t..................
...t.....b.........t........
...b...............b........
............................
MMMMMMMMMMMMM...............
MMMMMMMMMMMMMMMMMMMMMMMMMMMM
MMMMMMMMMMMMMMMMMMMMMMMMMMMM
MMMMMMMMMMMMMMMMMMMMMMMMMMMM
MMMMMMMMMMMMMMMMMMMMMMMMMMMM
MMMMMMMMMMMMMMMMMMMMMMMMMMMM
MMMMMMMMMMMMMMMMMMMMMMMMMMMM
MMMMMMMMMMMMMMMMMMMMMMMMMMMM
MMMMMMMMMMMMMMMMMMMMMMMMMMMM
MMMMMMMMMMMMMMMMMMMMMMMMMMMM
MMMMMMMMMMMMMMMMMMMMMMMMMMMM
..MMMMMMMMMMMMMMMMMMMMMMMMMM
....MMMMMMMMMMMMMMMMMMMMMMMM
......MMMMMMMMMMMMMMMMMMMMMM
.......MMMMMMMMMMMMMMMMMMMMM
[UNDER]
............................
SSSSSSSSSSSSS...............
SSSSSSSSSSSSSSSSSSSSSSSSSSSS
SSSSSSSSSSSSSSSSSSSSSSSSSSSS
GGGGGGGGGGGGGSSSSSSSSSSSSSSS
GGGGGGGGG.GGGGGGGGGGGGGGGGGG
GGG.GGGGG.GGGGGGGGG.GGGGGGGG
GGG.GGGGGGGGGGGGGGG.GGGGGGGG
GGGGGGGGGGGGGGGGGGGGGGGGGGGG
.............GGGGGGGGGGGGGGG
............................
............................
............................
............................
............................
............................
............................
............................
............................
............................
GG..........................
GGGG........................
GGGGGG......................
GGGGGGG.....................
[ENTITY]