d1_0_1.map
[RSC]
G stone.png
W wall.png
[AT]
WWWWWWWWW.......WWWWWWWWWWWW
W..........................W
W..........................W
W..........................W
W..........................W
W..........................W
W..........................W
W..........................W
W..........................W
W...........................
W...........................
W...........................
W...........................
W...........................
W...........................
W...........................
W..........................W
W..........................W
W..........................W
W..........................W
W..........................W
W..........................W
W..........................W
WWWWWWWWW.......WWWWWWWWWWWW
[UNDER]
WWWWWWWWWGGGGGGGWWWWWWWWWWWW
WGGGGGGGGGGGGGGGGGGGGGGGGGGW
WGGGGGGGGGGGGGGGGGGGGGGGGGGW
WGGGGGGGGGGGGGGGGGGGGGGGGGGW
WGGGGGGGGGGGGGGGGGGGGGGGGGGW
WGGGGGGGGGGGGGGGGGGGGGGGGGGW
WGGGGGGGGGGGGGGGGGGGGGGGGGGW
WGGGGGGGGGGGGGGGGGGGGGGGGGGW
WGGGGGGGGGGGGGGGGGGGGGGGGGGW
WGGGGGGGGGGGGGGGGGGGGGGGGGGG
WGGGGGGGGGGGGGGGGGGGGGGGGGGG
WGGGGGGGGGGGGGGGGGGGGGGGGGGG
WGGGGGGGGGGGGGGGGGGGGGGGGGGG
WGGGGGGGGGGGGGGGGGGGGGGGGGGG
WGGGGGGGGGGGGGGGGGGGGGGGGGGG
WGGGGGGGGGGGGGGGGGGGGGGGGGGG
WGGGGGGGGGGGGGGGGGGGGGGGGGGW
WGGGGGGGGGGGGGGGGGGGGGGGGGGW
WGGGGGGGGGGGGGGGGGGGGGGGGGGW
WGGGGGGGGGGGGGGGGGGGGGGGGGGW
WGGGGGGGGGGGGGGGGGGGGGGGGGGW
WGGGGGGGGGGGGGGGGGGGGGGGGGGW
WGGGGGGGGGGGGGGGGGGGGGGGGGGW
WWWWWWWWWGGGGGGGWWWWWWWWWWWW
[ENTITY]
