d1_0_0.map
[RSC]
G stone.png
W wall.png
[AT]
WWWWWWWWWWWWWWWWWWWWWWWWWWWW
W..........................W
W..........................W
W..........................W
W..........................W
W..........................W
W..........................W
W..........................W
W..........................W
W...........................
W...........................
W...........................
W...........................
W...........................
W...........................
W...........................
W..........................W
W..........................W
W..........................W
W..........................W
W..........................W
W..........................W
W..........................W
WWWWWWWWW.......WWWWWWWWWWWW
[UNDER]
WWWWWWWWWWWWWWWWWWWWWWWWWWWW
WGGGGGGGGGGGGGGGGGGGGGGGGGGW
WGGGGGGGGGGGGGGGGGGGGGGGGGGW
WGGGGGGGGGGGGGGGGGGGGGGGGGGW
WGGGGGGGGGGGGGGGGGGGGGGGGGGW
WGGGGGGGGGGGGGGGGGGGGGGGGGGW
WGGGGGGGGGGGGGGGGGGGGGGGGGGW
WGGGGGGGGGGGGGGGGGGGGGGGGGGW
WGGGGGGGGGGGGGGGGGGGGGGGGGGW
WGGGGGGGGGGGGGGGGGGGGGGGGGGG
WGGGGGGGGGGGGGGGGGGGGGGGGGGG
WGGGGGGGGGGGGGGGGGGGGGGGGGGG
WGGGGGGGGGGGGGGGGGGGGGGGGGGG
WGGGGGGGGGGGGGGGGGGGGGGGGGGG
WGGGGGGGGGGGGGGGGGGGGGGGGGGG
WGGGGGGGGGGGGGGGGGGGGGGGGGGG
WGGGGGGGGGGGGGGGGGGGGGGGGGGW
WGGGGGGGGGGGGGGGGGGGGGGGGGGW
WGGGGGGGGGGGGGGGGGGGGGGGGGGW
WGGGGGGGGGGGGGGGGGGGGGGGGGGW
WGGGGGGGGGGGGGGGGGGGGGGGGGGW
WGGGGGGGGGGGGGGGGGGGGGGGGGGW
WGGGGGGGGGGGGGGGGGGGGGGGGGGW
WWWWWWWWWGGGGGGGWWWWWWWWWWWW
[ENTITY]
