d1_1_0.map
[RSC]
G stone.png
W wall.png
[AT]
WWWWWWWWWWWWWWWWWWWWWWWWWWWW
W..........................W
W..........................W
W..........................W
W..........................W
W..........................W
W..........................W
W..........................W
W..........................W
...........................W
...........................W
...........................W
...........................W
...........................W
...........................W
...........................W
W..........................W
W..........................W
W..........................W
W..........................W
W..........................W
W..........................W
W..........................W
WWWWWWWWWWWWWWWWWWWWWWWWWWWW
[UNDER]
WWWWWWWWWWWWWWWWWWWWWWWWWWWW
WGGGGGGGGGGGGGGGGGGGGGGGGGGW
WGGGGGGGGGGGGGGGGGGGGGGGGGGW
WGGGGGGGGGGGGGGGGGGGGGGGGGGW
WGGGGGGGGGGGGGGGGGGGGGGGGGGW
WGGGGGGGGGGGGGGGGGGGGGGGGGGW
WGGGGGGGGGGGGGGGGGGGGGGGGGGW
WGGGGGGGGGGGGGGGGGGGGGGGGGGW
WGGGGGGGGGGGGGGGGGGGGGGGGGGW
GGGGGGGGGGGGGGGGGGGGGGGGGGGW
GGGGGGGGGGGGGGGGGGGGGGGGGGGW
GGGGGGGGGGGGGGGGGGGGGGGGGGGW
GGGGGGGGGGGGGGGGGGGGGGGGGGGW
GGGGGGGGGGGGGGGGGGGGGGGGGGGW
GGGGGGGGGGGGGGGGGGGGGGGGGGGW
GGGGGGGGGGGGGGGGGGGGGGGGGGGW
WGGGGGGGGGGGGGGGGGGGGGGGGGGW
WGGGGGGGGGGGGGGGGGGGGGGGGGGW
WGGGGGGGGGGGGGGGGGGGGGGGGGGW
WGGGGGGGGGGGGGGGGGGGGGGGGGGW
WGGGGGGGGGGGGGGGGGGGGGGGGGGW
WGGGGGGGGGGGGGGGGGGGGGGGGGGW
WGGGGGGGGGGGGGGGGGGGGGGGGGGW
WWWWWWWWWWWWWWWWWWWWWWWWWWWW
[ENTITY]
